10001111111000111111
10000100001000010000
10000100001000010000
10100100001000010000
10000100001000010000
10000100000000010000
10000000000000010000
10000000001000010000
10000100001000010000
10000100001000010000
10000100001000000000
10000100001000000000
10000100001000010000
10000100001000010000
10000100001000010000
10000100001000010000
10000100001000010000
10000100001000010000
10000100001000010000
11111111111111111111
