34034343434343403434
00000000000000000001
00000000000000000003
00000000000000000001
00000000000000000003
00000000000000000001
00000000000000000003
00000000001200000001
00000000003400000003
00000000001200000001
00000000003400000003
00000000000000000001
00000000000000000003
00000000000000000001
00000000000000000003
00000000000050000001
00000000000060000003
00000000000000000001
00000000000000000003
12121212121212121212
