11011111111111101111
00000100001000000001
00000100001000010001
00000100001000010001
00000100001000010001
00000100001000010001
00000100001000010001
00000100001000010001
00000100001000010001
00000100001000010001
00000100001000010001
00000100001000010001
00000100001000010001
00000100001000010001
00000100001000010001
00000000000000000001
00000000000000000001
00000000000000000001
00000000000000000001
11111111111111111111
