34343434343434343434
20000000000000000001
40000000000000000003
00000000000000000001
00000000000000000003
00000000012000000001
20000000034000000003
40000000000000000001
00000000000000000003
00000005000000000001
00000006000000500003
00000000000000600001
00000120000000000003
20000340000000000001
40000000000000000003
00000000000000000001
00000000000000000003
00000000000000000001
00000000000000000003
12012121212121201212
