11111111111111111111
00000100001000010001
10000100001000010001
10000100001000010001
10000100001000010001
10000100001000010001
10000100001000010001
10000100001000010001
10000100001000010001
00000100001000010001
00000100001000010001
10000100001000010001
10000100001000010001
10000100001000010001
10000100001000010001
10000000000000000001
10000000000000000001
00000000000000000001
00000000000000000001
11011111111111101111
