0000000000000000000000000000000000000000
0000000000000000000000000000000000000000
0000000000000000000000000000000000000000
0000000000000000000000000000000000000000
0000000000000000000000000000000000000000
0000000000000000000000000000000000000000
0000000000000000000000000000000000000000
0000000000000000000000000000000000000000
0000000000000000000000000000000000000000
0000000000000000000000000000000000000000
0000000000000000000000000000000000000000
6100000000000000000000000000000000000061
6161616161616161616161616161616161616161
0000000000000000006161616161000000000000
0000000000000000616161616161000000000000
0000000000000061626161626161610000000000
0000000000000061616161616261616100000000
0000000000000061626162616261610000000000
0000000000000061616261616161610000000000
0000000000000061616161616161610000000000
0000000000000000000000000000000000000000
0000000000000000000000000000000000000000
0912121212121212121212121212121212121211
0912121212121212121212121212121212121211
0912121212121212121212121212121212121211
0912121212121212121212121212121212121211
0912121212121212121212121212121212121211
0912121212121212121212121212121212121211
0912121212121212121212121212121212121211
0912121212121212121212121212121212121211
0912121212121212121212121212121212121211
0812121212121212121212121212121212121207
6667666766676667666766676667666766676667
7170717071707170716968696870717071707170
7071707170717071690000000068707170717071
7170717071707169000000000000687071707170
7071707170717067000000000000667170717071
7170717071707169000000000000687071707170
7071707170717067000000000000667170717071
7170717071707169000000006667687071707170
0000000000000000000000000000000000000000
0000000000000000000000000000000000000000
0000000000000000000000000000000000000000
0000000000000000000000000000000000000000
0000000000000000000000000000000000000000
0000000000000000000000000000000000000000
0000000000000000000000000000000000000000
0000000000000000000000000000000000000000
0000000000000000000000000000000000000000
0000000000000000000000000000000000000000
0000000000000000000000000000000000000000
0000000000000000000000000000000000000000
0000000000000000000000000000000000000000
0000000000000000000000000000000000000000
0000000000000000000000000000000000000000
0000000000000000000000000000000000000000
0000000000000000000000000000000000000000
0000000000000000000000000000000000000000
0000000000000000000000000000000000000000
0000000000000000000000000000000000000000
0000000000000000000000000000000000000000
0000000000000000000000000000000000000000
0000000000000000000000000000000000000000
0000000000000000000000000000000000000000
0000000000000000000000000000000000000000
0000000000000000000000000000000000000000
0000000000000000000000000000000000000000
0000000000000000000000000000000000000000
0000000000000000000000000000000000000000
0000000000000000000000000000000000000000
0000000000000000000000000000000000000000
0000000000000000000000000000000000000000
0000000000000000000000000000000000000000
0000000000000000000000000000000000000000
0000000000000000000000000000000000000000
0000000000000000000070000000000000000000
0000000000000000000000000000000000000000
0000000000000000000000000000000000000000
0000000000000000000000000000000000000000
0000000000000000505018185050000000000000