0000000000000000000000000000000000000000
0000000000000000000000000000000000000000
0000006262626262616161616161616161616161
0000626161616161616261616161616161610061
0000626161000061616161616100000061610061
0062626161006161616161616100000061610061
0062626100616161616162616161000061610061
6262626161616161616161616162610061616161
6161616161616161626161616161616161616161
6161616161616161616161616162616161626161
6161626161626161626161616161616161616161
6161616161616161616161616161616161616161
6161616100616161616161616161616161616161
0000616100006161616161626161000061610000
0000616100006161616161616100000061610000
0000616100000000616161610000000061610000
0000616161616161616161616161616161610000
0000616161616161616261616161616161610000
0000006100006161616161616100000000000000
0000000000000061616161616100000000000000
0000000000000000000000000000000000000000
0000000000000000000000000000000000000000
7170716966676667000000006667667169666766
7071696671707170670000667170717067687071
7170676870717071690000687071707169667170
7071696671707169000000006870717067687071
7170676870716900000000000068707169667170
6968696671690000000000000000687067686968
0000006869000000000000000000006869000000
0000000000000000006667000000000000000000
0000000000000000006869000000000000000000
0000006667000000000000000000006667000000
6766676870670000000000000000667169666766
7071696671706700000000000066717067687071
7170676870717067000000006671707169667170
7071696671707170670000667170717067687071
7170676869686968690000686968696869667170
7071706766676667000000006667666766717071
7170717071707169000000006870717071707170
7071707170717067000000006671707170717071
0000000000000000000000000000000000000000
0000000000000000000000000000000000000000
0000000000000000000000000000000000000000
0000000000000000000000000000000000000000
0000000000000000000000000000000000000000
0000000000000000000000000000000000000000
0000000000000000000000000000000000000000
0000000000000000000000000000000000000000
0000000000000000000000000000000000000000
0000000000000000000000000000000000000000
0000000000000000000000000000000000000000
0000000000000000000000000000000000000000
0000000000000000000000000000000000000000
0000000000000000000000000000000000000000
0000000000000000000000000000000000000000
0000000000000000000000000000000000000000
0000000000000000000000000000000000000000
0000000000000000000000000000000000000000
0000000000000000000000000000000000000000
0000000000000000000000000000000000000000
0000000000000000000000000000000000000000
0000000000000000000000000000000000000000
0000000000000000610000610000000000000000
0000000000000000001818000000000000000000
0000000000000000000000000000000000000000
0000000000000000000000000000000000000000
0000000000000009090900006800000000000000
0000000000000009090900000000000000000000
5057500000000000000000000000000000505450
0018000000000000000000100000000000001800
0018000000000000000000000000000000001800
5054500000000000000000000909000000505750
0000000000000009090000000909000000000000
0000000000000009090900000000000000000000
0000000000000000090900000000000000000000
0000000000000000000000000000000000000000
0000000000000000000000000000000000000000
0000000000000000610000610000000000000000
0000000000000000611818610000000000000000
0000000000000000610000610000000000000000