0000000000000000000000000000000000000000
0000000000000000000000000000000000000000
0000000000000000000000000000000000000000
0000000000000000000000000000000000000000
0000000000000000000000000000000000000000
0000000000000000000000000000000000000000
0000000000002929292929292900000000000000
0000000000002929292929292900000000000000
0000000000002930303030302900000000000000
0000000000002930303030302900000000000000
0000000000002930303030302900000000000000
0000000000002930303030302900000000000000
0000000000002930303030302900000000000000
0000000000002929292929292900000000000000
0000000000000000002900000000000000000000
0000000000000000000000000000000000000000
0000000000000000000000000000000000000000
0000000000000000000000000000000000000000
0000000000000000000000000000000000000000
0000000000000000000000000000000000000000
0000000000000000000000000000000000000000
0000000000000000000000000000000000000000
0000000000000000000000000000000000000000
0000000000000000000000000000000000000000
0000000000000000000000000000000000000000
0000000000424443444343434441000000000000
0000000000420000000000000041000000000000
0000000000420000000000000041000000000000
0000000000420000000000000041000000000000
0000000000420000000000000041000000000000
0000000000420000000000000041000000000000
0000000000420000000000000041000000000000
0000000000420000000000000041000000000000
0000000000420000000000000041000000000000
0000000000134545470048454546000000000000
0000000000000000134546000000000000000000
0000000000000000000000000000000000000000
0000000000000000000000000000000000000000
0000000000000000000000000000000000000000
0000000000000000000000000000000000000000
0000000000000000000000000000000000000000
0000000000000000000000000000000000000000
0000000000000000000000000000000000000000
0000000000000000000000000000000000000000
0000000000000000000000000000000000000000
0000000000000000000000000000000000000000
0000000000000000000000000000000000000000
0000000000000000000000000000000000000000
0000000000000000000000000000000000000000
0000000000000000000000000000000000000000
0000000000000000000000000000000000000000
0000000000000000000000000000000000000000
0000000000000000000000000000000000000000
0000000000000000000000000000000000000000
0000000000000000000000000000000000000000
0000000000000000000000000000000000000000
0000000000000000000000000000000000000000
0000000000000000000000000000000000000000
0000000000000000000000000000000000000000
0000000000000000000000000000000000000000
0000000000000000000000000000000000000000
0000000000000000000000000000000000000000
0000000000000000000000000000000000000000
0000000000000000000000000000000000000000
0000000000000000000000000000000000000000
0000000000000000000000000000000000000000
0000000000000000000000100000000000000000
0000000000000000000000000000000000000000
0000000000000009090909090000000000000000
0000000000000009090909090000000000000000
0000000000000009090909090000000000000000
0000000000000009090909090000000000000000
0000000000000009090909090000000000000000
0000000000000000000000000000000000000000
0000000000000000001800000000000000000000
0000000000000000000000000000000000000000
0000000000000000000000000000000000000000
0000000000000000000000000000000000000000
0000000000000000000000000000000000000000
0000000000000000000000000000000000000000