0000000000000000000000000000000000000000
0000000000000000000000000000000000000000
0000000000000000000000000000000000000000
0000000000000000000000000000000000000000
0000000000000000000000000000000000000000
0000001113131313131313131313131308000000
0000001407070707070707070707070715000000
0000001407070707070707070707070715000000
0000001407070707070707070707070715000000
0000001407070707070707070707070715000000
0000001407070707070707070707070715000000
0000001407070707070707070707070715000000
0000001407070707070707070707070715000000
0000001407070707070707070707070715000000
0000001407070707070707070707070715000000
0000001407070707070707070707070715000000
0000001012121212120712121212121209000000
0000000000000000000700000000000000000000
0000000000000000000000000000000000000000
0000000000000000000000000000000000000000
0000000000000000000000000000000000000000
0000000000000000000000000000000000000000
0000000000000000000000000000000000000000
0000000000000000000000000000000000000000
0000424344434343434443434343434443410000
0000420000000000000000000000000000410000
0000420000000000000000000000000000410000
0000420000000000000000000000000000410000
0000420000000000000000000000000000410000
0000420000000000000102000000000000410000
0000420000000000000304000000000000410000
0000420000000000000000000000000000410000
0000420000000000000000000000000000410000
0000420000000000000000000000000000410000
0000420000000000000000000000000000410000
0000420000000000000000000000000000410000
0000420000000000000000000000000000410000
0000134545454545470048454545454545460000
0000000000000000134546000000000000000000
0000000000000000000000000000000000000000
0000000000000000000000000000000000000000
0000000000000000000000000000000000000000
0000000000000000000000000000000000000000
0000000000000000000000000000000000000000
0000000000000000000000000000000000000000
0000000000000000000000000000000000000000
0000000000040000000000000004000000000000
0000000000000000000000000000000000000000
0000000000000000000000000000000000000000
0000000000000000000000000000000000000000
0000000000050000000000000000000000000000
0000000000000000000000000000000000000000
0000000000000000000000000000000000000000
0000000000000000000000000000050000000000
0000000000000000000000000000000000000000
0000000000000000000000000000000000000000
0000000000000000000000000000000000000000
0000000000000000000000000000000000000000
0000000000000000000000000000000000000000
0000000000000000000000000000000000000000
0000000000000000000000000000000000000000
0000000000000000000000000000000000000000
0000000000000000000000000000000000000000
0000000000000000000000000000000000000000
0000000000003000000000003000000000000000
0000000000000000000000000000000000000000
0000000000000000002324000000000000000000
0000000000000000002526000000000000000000
0000000044000047000000000000004300000000
0000000000000000000000000000000000000000
0000000000000000000000000000000000000000
0000000000000000000000000000000000000000
0000000000000000000000004600000000000000
0000000000000000000000000000000000000000
0000000000000000000000000000000000000000
0000000000000000000000000000000000000000
0000000000000000000000000000000000000000
0000000000000000000000000000000000000000
0000000000000000000000000000000000000000
0000000000000000000000000000000000000000
