0000000000000000000000000000000000000000
0000000000000000000000000000000000000000
0000000000000000000000000000000000000000
0000000000000000000000000000000000000000
0000000000000000000000000000000000000000
0000000000000000000000000000000000000000
0000000000000000000000000700000000000000
0000000000000000000000110708000000000000
0000000000131313080000140706000000000000
0000000007070707070000140706000000000000
0000000000070707071313070706000000000000
0000000007070707070707070700000000000000
0000000000070707070707070000000000000000
0000000014070707070707070015000000000000
0000000014070707070707000015000000000000
0000000010120712121212000009000000000000
0000000000000700000000000000000000000000
0000000000000000000000000000000000000000
0000000000000000000000000000000000000000
0000000000000000000000000000000000000000
0000000000000000000000000000000000000000
0000000000000000000000000000000000000000
0000000000000000000000000000000000000000
0000000000000000000000000000000000000000
0000000000000000000000000000000000000000
0000000000000000000000004000000000000000
0000000000000000000042440044410000000000
0000004243434343434142000000410000000000
0000004240000000004142000040410000000000
0000004240400000004343006340410000000000
0000004240406300000000000040410000000000
0000004240400000000000000040410000000000
0000004240006300000063004040410000000000
0000004200000000004040004000410000000000
0000004200000063004040404000410000000000
0000004200000000004040404000410000000000
0000001345470048454545454545460000000000
0000000000134546000000000000000000000000
0000000000000000000000000000000000000000
0000000000000000000000000000000000000000
0000000000000000000000000000000000000000
0000000000000000000000000000000000000000
0000000000000000000000000000000000000000
0000000000000000000000000000000000000000
0000000000000000000000000000000000000000
0000000000000000000000000000000000000000
0000000000000000000000000000000000000000
0000000000000000000000000000000000000000
0000000000000000000000000000000000000000
0000000000000000000000000000000000000000
0000000000000000000000000000000000000000
0000000000000000000000000000000000000000
0000000000000000000000000000000000000000
0000000000000000080000000000000000000000
0000000000000000000000000000000000000000
0000000008000000000000000000000000000000
0000000000000000000000000000000000000000
0000000000000000000000000000000000000000
0000000000000000000000000000000000000000
0000000000000000000000000000000000000000
0000000000000000000000000000000000000000
0000000000000000000000000000000000000000
0000000000000000000000000000000000000000
0000000000000000000000000000000000000000
0000000000000000000000000000000000000000
0000000000000000000000000000000000000000
0000000000000000000000000000000000000000
0000000000363500360000470046000000000000
0000000000040004040000000000000000000000
0000000000000050003636003600000000000000
0000000000003600000000000000000000000000
0000000000000000010000000900000000000000
0000000000003600000036090000000000000000
0000000000000000000000090009000000000000
0000000000000036000000000009000000000000
0000000000000000000000000009000000000000
0000000000001800000000000000000000000000
0000000000000000000000000000000000000000
0000000000000000000000000000000000000000
0000000000000000000000000000000000000000