0000000000000000000000000000000000000000
0000000000000000000000000000000000000000
0000000000000000000000000000000000000000
0000000707000000000000000000071700000000
0000000007070006000000000707070700000000
0000000707000006000000000007070700000000
0000070707070006060000000007070707000000
0000070700070707060707070007070707000000
0000070007000000060000000007000007000000
0000070707071313130013000000000707000000
0000070707001212121212070707070707070000
0000000007000007000000070000070700000000
0000000007000000000000000000000000000000
0007070707000000000000000000000000000000
0000070007000000000000000000000000000000
0000000007000000000000000000000000000000
0000000707000000000000000000000000000000
0000000000000000000000000000000000000000
0000000000000000000000000000000000000000
0000000000000000000000000000000000000000
0000000000000000000000000000000000000000
0000000000000000000000000000000000000000
0000000040000000000000000000004000000000
0042434300434343434343434343430043430000
0042006300630040000000006363630063410000
0042636300634040400000006300000063410000
0042000040406363406363406300636363410000
0042004040000000400040636300000000410000
0042004063636300406363634063634000414000
0042004000000000404000634040636300434100
0042634000630000404000000040000000004100
0042004000636300634040636340636363484600
4243404000634063404040404040404040410000
4200004040634040404040400040000000410000
1347636340400000000000000040000000410000
0042006300404000000000000040000000410000
0042006300634040000000000040000000410000
0013454545454545454545454545454545460000
0000000000000000000000000000000000000000
0000000000000000000000000000000000000000
0000000000000000000000000000000000000000
0000000000000000000000000000000000000000
0000000000000000000000000000000000000000
0000000000000000000000000000000000000000
0000000000000000000000000000000000000000
0000000000000000000000000000000000000000
0000000000000000000000000000000000000000
0000000000000000000000000008000000000000
0000000000000000000000000000000000000000
0000000000000000000000000000000005000000
0000000000000000000000000000000000000000
0000000000000000000000000000000000000000
0000000000000000000000000000000000000000
0000000000000000000000000000000000000000
0000000000000000000000000000000000000000
0000000000000000000000000000000000000000
0000000000000000000000000000000000000000
0000000000000000000000000000000000000000
0000000000000000000000000000000000000000
0000000000000000000000000000000000000000
0000000000000000000000000000000000000000
0000000000000000000000000000000000000000
0000000000000000000000000000000000000000
0000000012000000000000000000000000000000
0000003600000000000000003600000000000000
0000000000000000000000003600000000000000
0000000000000000003600000000000036000000
0000190000000000000000000000000000000000
0000000036360020000000000000000000000000
0000000000360000000000000000003600000000
0000000000000000000000200000210000180000
0000000000360038000000000000003600000000
0000000000000000000000000000000000000000
0018000000000000000000000000000000000000
0000000020000000000000000000000000000000
0000000000000000000000000000000000000000
0000000018000000000000000000000000000000
0000000000000000000000000000000000000000
0000000000000000000000000000000000000000
0000000000000000000000000000000000000000