0000000000000000000000000000000000000000
0000000000000000000000000000000000000000
0000000000000000000000000000000000000000
0000000061626161616217616161616261000000
0000000061616162616117626161616161000000
0000000062616161616117616161616161000000
0000000061616161616117616161616261000000
0000000061616162616117626162616161000000
0000000061616161616117616161616161000000
0000000061616161616117616161616161000000
0000000061616161616117616261616161000000
0000000000000000303017000000000000000000
0000000000000000003003000000000000000000
0000000000000000000003000000000000000000
0000000000000000000003000000000000000000
0000000000000000000003000000000000000000
0000000000000000000017000000000000000000
0000000061616162616117626161616161000000
0000000061616261626117616161626162000000
0000000062616161616117616261616261000000
0000000000000000000000000000000000000000
0000000000000000000000000000000000000000
0000004243434343434344434343434343410000
0000004200000000000000000000000000410000
0000004200000000000000000000000000410000
0000004200000000000000000000000000410000
0000004200000000000000000000000000410000
0000004200666700000000000000666700410000
0000004200686900000000000000686900410000
0000004200000000000000000000000000410000
0000004252000000000000000000000053410000
0000001345454545454700484545454545460000
0000000000000000004200410000000000000000
0000000000000000004200410000000000000000
0000000000000000004200410000000000000000
0000000000000000004200410000000000000000
0000004243434443434300434344434343410000
0000004200000000000000000000000000410000
0000004200000052000000000000000000410000
0000004266676667666700666766676667410000
0000000000000000000000000000000000000000
0000000000000000000000000000000000000000
0000000000000000000000000000000000000000
0000000000000000000000000000000000000000
0000000000000000000000000000000000000000
0000000000000000000000000000000000000000
0000000000000000000000000000000000000000
0000000000000000000000000000000000000000
0000000000000000000000000000000000000000
0000000000000000000000000000000000000000
0000000000000000000000000000000000000000
0000000000000000000000000000000000000000
0000000000000000000000000000000000000000
0000000000000000000000000000000000000000
0000000000000000000000000000000000000000
0000000000000000000000000000000000000000
0000000000000000000000000000000000000000
0000000000000000000000000000000000000000
0000000000000000000000000000000000000000
0000000000000000000000000000000000000000
0000000000000000000000000000000000000000
0000000000000000000000000000000000000000
0000000035300040300000003040003035000000
0000000000000000004700460000000000000000
0000000000000000000000000023240000000000
0000000000002526000000000025260000000000
0000000000000000005600560000000000000000
0000000000000000000000000000000000000000
0000000000000000005600560000000000000000
0000000000000000000000000000000000000000
0000000000000000000000000000000000000000
0000000000000000000000000000000000000000
0000000000000000000000000000000000000000
0000000000000000000000000000000000000000
0000000000000000000000000000000000000000
0000000000000000000000000000000000000000
0000000000000030000000000000300000000000
0000000000000000000000000000000000000000
0000000000000000000018000046000000000000
0000000000000000000000000000000000000000
