0000000000000000000000000000000000000000
0000000000000000000000000000000000000000
0000006161616161616117616161616161000000
0000000061616261616117616261626161000000
0000000061626161626117626161616162000000
0000000061616161616117616161626161000000
0000000061616161616117616161616161000000
0000000061616161616117616161616161000000
0000000061616161616117616161616162000000
0000000061616161626117616261616161000000
0000000061626162616117616261616261000000
0000000062626161616217616161616161000000
0000000061616161616117616161616161000000
0000000061616161616117616161616161000000
0000000061616161616117616161616161000000
0000000062616161616217616261626162610000
0000000061616262616117616261616161000000
0000000061626161616117616161626162000000
0000000000000000000017000000000000000000
0000000000000000000000000000000000000000
0000000000000000000000000000000000000000
0000004040404040404040404040404040400000
0000004268707170716900687071707169410000
0000004200686968690000006869686900410000
0000004200000000000000000000000000410000
0000004200000000000000000000000000410000
0000004266676667666700666766676667410000
0000004268707170716900687071707169410000
0000004200686968690000006869686900410000
0000004200000000000000000000000000410000
0000004200000000000000000000000000410000
0000004200000000000000000000000000410000
0000004266676667666700666766676667410000
0000004268707170716900687071707169410000
0000004200686968690000006869686900410000
0000004200000000000000000000000000410000
0000004200000000000000000000000000410000
0000004200000000000000000000000000410000
0000001345454545454545454545454545460000
0000000000000000000000000000000000000000
0000000000000000000000000000000000000000
0000000000000000000000000000000000000000
0000000000000000000000000000000000000000
0000000000000000000000000000000000000000
0000000000000000000000000000000000000000
0000000000000000000000000007000000000000
0000000000000000000000000000000000000000
0000000000000000000000000000000000000000
0000000000000000000000000000000000000000
0000000000000000000000000000000000000000
0000000000000000070000000000000000000000
0000000000000000000000000000000000000000
0000000000000000000000000000000000000000
0000000000000000000000000000000000000000
0000000000000000000000000000000000000000
0000000000000000000000000000000000000000
0000000000000600000000070000000000000000
0000000000000000000000000000000000000000
0000000000000000000000000000000000000000
0000000000000000000000000000000000000000
0000000000000000000000000000000000000000
0000000000000000000000000000000000000000
0000000000000000000000000000000000000000
0000000000000000005000500000000000000000
0000000000000000000000000000000000000000
0000000000000000000000000000000000000000
0000000000000000000000000000000000000000
0000000000000000000000000000000000000000
0000000000000000000000000000000000000000
0000000000000046000000000000000000000000
0000000000000000000000000000000000000000
0000000000000000000000000000000000000000
0000000000000000000000000000000000000000
0000000000000000000000000000000000000000
0000000000000000000000000000000000000000
0000000000000000000000000000000000000000
0000000000000000000000000047000000000000
0000000000000000000018000000000000000000
0000000000000000000000000000000000000000
0000000000000000000000000000000000000000