0000000000000000000000000000000000000000
0000000000000000000000000000000000000000
0000000000000000000000000000000000000000
0000000000000000000000000000000000000000
0000000000000000070000000000000000000000
0000000000111313071313130800000000000000
0000000000140707070707071500000000000000
0000000000140707070707071500000000000000
0000000007070707070707070707000000000000
0000000000140707000707071500000000000000
0000000000140707000707071500000000000000
0000000000100712001212120900000000000000
0000000000000700000000000000000000000000
0000000000000700000000000000000000000000
0000000000000700000000000000000000000000
0000000000000700000000000000000000000000
0000000000000700000000000000000000000000
0000000000000700000000000000000000000000
0000000000000000000000000000000000000000
0000000000000000000000000000000000000000
0000000000000000000000000000000000000000
0000000000000000000000000000000000000000
0000000000000000000000000000000000000000
0000000000000042434100400000000000000000
0000000042434443004343404341000000000000
0000000040400000630040400041000000000000
0000000042404000000040006341000000000000
0000004243634040404040000043410000000000
0000004200000063404040000000410000000000
0000001347000000400040000048460000000000
0000000042000000400040006341000000000000
0000000042000000400040400041000000000000
0000000013470048454545454546000000000000
0000000000420041000000000000000000000000
0000000000420041000000000000000000000000
0000000000420041000000000000000000000000
0000000000420041000000000000000000000000
0000000000420041000000000000000000000000
0000000000134546000000000000000000000000
0000000000000000000000000000000000000000
0000000000000000000000000000000000000000
0000000000000000000000000000000000000000
0000000000000000000000000000000000000000
0000000000000000000000000000000000000000
0000000000000000000000000000000000000000
0000000000000000000000000000000000000000
0000000000000000000000000000000000000000
0000000000000000000000000000000000000000
0000000000000000000000000000000000000000
0000000000000000000000000000000000000000
0000000000000000000000000000000000000000
0000000000000800000000000000000000000000
0000000000000000000000000000000000000000
0000000000000000000000000000000000000000
0000000000000000000000000000000000000000
0000000000000800000000000000000000000000
0000000000000000000000000000000000000000
0000000000000000000000000000000000000000
0000000000000000000000000000000000000000
0000000000000000000000000000000000000000
0000000000000000000000000000000000000000
0000000000000000000000000000000000000000
0000000000000000000000000000000000000000
0000000000000000000000000000000000000000
0000000000000000180000000000000000000000
0000000000000020362000000000000000000000
0000000000000020202000003600000000000000
0000000000000000000000191900000000000000
0000000018000036000000190018000000000000
0000000000000009000000191900000000000000
0000000000000009000900000000000000000000
0000000000000009000900000000000000000000
0000000000000000000000000000000000000000
0000000000000000000000000000000000000000
0000000000000000000000000000000000000000
0000000000000000000000000000000000000000
0000000000000000000000000000000000000000
0000000000001800000000000000000000000000
0000000000000000000000000000000000000000
0000000000000000000000000000000000000000