0000000000000000000000000000000000000000
0000000000000000000000000000000000000000
0000000000000000000000000000000000000000
0000000000000000000000000000000000000000
0000000000000000110707070000000000000000
0000000000000000000707070000000000000000
0000111107081200000707070011130800000000
0000000007070000001212120014071500000000
0012101212120900000000070014070708000000
0000000000000000111313080014070709000000
0000110713131300140707150014071500000000
0007071207070700140707150014071500000000
0007101212121212101212090010120900000000
0000000000000000000000070000000700000000
0000000000000000110000080000000000000000
0000000000000000100707090900000000000000
0000000000000000000000000000000000000000
0000000000000000000000000000000000000000
0000000000000000000000000000000000000000
0000000000000000000000000000000000000000
0000000000000000000000000000000000000000
0000000000000000000000000000000000000000
0000000000000000000000000000000000000000
0000000000000042434443444341000000000000
0000000000000042630000006341000000000000
0042434344434343630000006343434341000000
0042630000006340630000006300000041000000
0042630000006340630000006300000043410000
0042000000000040636363636300000000410000
0042404040404040000000006300000000410000
0042636300000063000000006300000048460000
0042000000000063000000006300000041000000
0042000000000063000000006300000041000000
0013454545454547636363636348454546000000
0000000000000042000000006341000000000000
0000000000000042000000006341000000000000
0000000000000013454545454546000000000000
0000000000000000000000000000000000000000
0000000000000000000000000000000000000000
0000000000000000000000000000000000000000
0000000000000000000000000000000000000000
0000000000000000000000000000000000000000
0000000000000000000000000000000000000000
0000000000000000000000000000000000000000
0000000000000000000000040000000000000000
0000000000000000000000000000000000000000
0000000000000000000000000000000000000000
0000000000000000000000000000000000000000
0000000000000000000000000000000000000000
0000000000000000000000000000000000000000
0000000000000000000000000000000000000000
0000000000000000000000000000000000000000
0000000000000000000000000000000000000000
0000000000000000000000000000000000000000
0000000000000000000000000000000000000000
0000000000000000000000000000000000000000
0000000000000000000000000000000000000000
0000000000000000000000000000000000000000
0000000000000000000000000000000000000000
0000000000000000000000000000000000000000
0000000000000000000000000000000000000000
0000000000000000000000000000000000000000
0000000000000000000000000000000000000000
0000000000000000000000000000000000000000
0000000000000000003800000000000000000000
0000000000000000000000000000000000000000
0000000007000000000000000000380000000000
0000002020200000000000380000000000000000
0000000000380000000000000000000018000000
0000000000000000381900000000000018000000
0000000000000000001900000000000000000000
0000211900003800191900000000000000000000
0000001900000000000000380021380000000000
0000000000000000000000000000000000000000
0000000000000000381920000000000000000000
0000000000000000001920380000000000000000
0000000000000000000000000000000000000000
0000000000000000000000000000000000000000
0000000000000000000000000000000000000000
0000000000000000000000000000000000000000