0000000000000000000000000000000000000000
0000000000000000000000000000000000000000
0000000000000000000000000000000000000000
0000000000000000000000000000000000000000
0000000000000000000000000000000000000000
0000000000000000000000000000000000000000
0000000000000000000000000000000000000000
0000000065656565656565656565650000000000
0000000000650065000000000065656500000000
0000000065656565006565656565656500000000
0000000000656565000065000065656500000000
0000656500656565000000006565656500000000
0000000000656565000000000065656500000000
0000000065656565000000000065656500000000
0000000065656565656565656565656500000000
0000000065656565656565656565656500000000
0000000000000000000000000000000000000000
0000000000000000000000000000000000000000
0000000000000000000000000000000000000000
0000000000000000000000000000000000000000
0000000000000000000000000000000000000000
0000000000000000000000000000000000000000
0000000000000000000000000000000000000000
0000000000000000000000000000000000000000
0000000000000000000000000000000000000000
0000000000000000000000000000000000000000
0000004273737373737373737373734100000000
0000004200400040404040404040407341000000
0000004200400040404040404040400041000000
0000004200000000400000004040000041000000
0042737300000000400000004000000041000000
0042000000000000400000004000000041000000
0013454700000000400000004000000041000000
0000004200000000404040404000000041000000
0000004200000000404040000000000041000000
0000004200000000404040000000000041000000
0000001345454545454545454545454546000000
0000000000000000000000000000000000000000
0000000000000000000000000000000000000000
0000000000000000000000000000000000000000
0000000000000000000000000000000000000000
0000000000000000000000000000000000000000
0000000000000000000000000000000000000000
0000000000000000000000000000000000000000
0000000000000000000000000000000000000000
0000000000000000000000000000000000000000
0000000000000000000000000000000000000000
0000000000000000000000000000000000000000
0000000000000000000000000000000000000000
0000000000000000000000000000000000000000
0000000000000007000000000000000000000000
0000000000000000000000000000000000000000
0000000000000000000000000000000000000000
0000000000000000000000000000070000000000
0000000000070000000000000000000000000000
0000000000000000000000000000000000000000
0000000000000000000000000000000000000000
0000000000000000000000000000000000000000
0000000000000000000000000000000000000000
0000000000000000000000000000000000000000
0000000000000000000000000000000000000000
0000000000000000000000000000000000000000
0000000000000000000000000000000000000000
0000000000000000000000000000000000000000
0000000000000000000000000000000000000000
0000000000000000000000000000000000000000
0000000030000000300000003000000000000000
0000000038003800000000000000000000000000
0000000020001900000000000000003800000000
0000000000000000000000380000000000000000
0000000019000000002020200038000000000000
0000180019000000002007200000000000000000
0000000019000000002020200000000000000000
0000000000000000000000000000000000000000
0000000000000000000000380000000000000000
0000000000000000000000000000002100000000
0000000000000000000000000000000000000000
0000000000000000000000000000000000000000
0000000000000000000000000000000000000000
0000000000000000000000000000000000000000