0000000000000000000000000000000000000000
0000000000000000000000000000006565656500
0000000000000000000000000000656565656565
0000000065656565656500000000656565656565
0000006565656565656500000000656565656565
0000006565656565656565656565656565656500
0000006565656565656565656565656565656500
0000006565656565656565656565656565656500
0000006565656565656565656565656565656565
0000000065656565656565656565656565656565
0000000065656565656565656565656565656500
0000000065656565656565656565656565650000
0000000065656565656565656565656565000000
0000000065656565656565656565656500000000
0000000065656565656565656565000000000000
0000000065000000006565656565000000000000
0000656565650000006565656565000000000000
0000656565650000006500656565000000000000
0000656565650000006500000000000000000000
0000000000000000006500000000000000000000
0000000000000000000000000000000000000000
0000000000000000000000000000000000000000
0000000000000000000000000000000000000000
0000000000000000000000000000000000000000
0000000000000000000000000000636363636300
0000000000000000000063000063000000006300
0000000000000000000063000063000000000000
0000000000000000006363000063000000000000
0000000000636363636300000063000000000000
0000000063630000000000000063000000000000
0000000000000000000000000063000000000000
0000000000000000000000000063000000000000
0000000000000000000000000063000000000000
0000000063630000000063636363636300000000
0000000000630000000063000000000000000000
0000000000000000000063000000000000000000
0000000000000000000063000000000000000000
0000000000000000000000000000000000000000
0000000000000000000000000000000000000000
0000000000000000000000000000000000000000
0000000000000000000000000000000000000000
0000000000000000000000000000000000000000
0000000000000000000000000000000000000000
0000000000000000000000000000000000000000
0000000000000000000000000000000000000000
0000000000000000000000000000000000000000
0000000000000000000000000000000000000000
0000000000000000000000000000000000000000
0000000000000000000000000000000000000000
0000000000000000000000000000000000000000
0000000000000000000000000000000000000000
0000000000000000000000000000000000000000
0000000000000000000000000000000000000000
0000000000000000000000000000000000000000
0000000000000000000000000000000000000000
0000000000000000000000000000000000000000
0000000000000000000000000000000000000000
0000000000000000000000000000000000000000
0000000000000000000000000000000000000000
0000000000000000000000000000000000000000
0000000000000000000000000014141414141414
0000000000000000000000000014140030000014
0000001414141414141414000014000000000014
0000141400000000000014000014500000000014
0000143000000000003614141414000000000014
0000140036000000000000005000500000000014
0000140000005600003800003800000000003814
0000140000000000470000000000000000000014
0000143850000000000000000000000056003614
0000141400000000000000000000000000000014
0000001400000000000000360000000000000014
0000001400000000000000000000000000001414
0000001400000000005600005000000038141400
0000001400000000000000000000000014140000
0000001438005000000000500000141414000000
0014141400141414140000000000140000000000
0014380000001400140000000000140000000000
0014005600051400140014000030140000000000
0014080000061400141414141414140000000000
1414141414141400001400000000000000000000