0000000000000000000000000000000000000000
0000000000000000000000000000000000000000
0000000000000000000000000000000000000000
0000000065656565656506060600000000000000
0000006565656565656500000000656565656500
0000006565656565656565656565656565656500
0000006565656565656565656565656565656500
0000006565656565656565656565656565656500
0000006565656565656565656565656565656500
0000000065656565656565656565656565656500
0000000065656565656565656565656565656500
0000000065656565656565656565656565650000
0000000065656565656565656565656565000000
0000000065656565656565656565656500000000
0000000065656565656565656565000000000000
0000000065000000006565656565000000000000
0000656565650000006565656565000000000000
0000656565650000006500656565000000000000
0000656565650000000000000000000000000000
0000000000000000000000000000000000000000
0000000000000000000000000000000000000000
0000000000000000000000000000000000000000
0000000000000000004273737373737373737341
0000427373737373737300000040404040404041
0000420000000000006340404040636363636341
0000420063000000000063000063000000006341
0000420000000000000063000063000000000041
0000420000000000006363000063000000000041
0000420000636363636300000063000000006341
0000134763630000000000000063000000000041
0000004200000000000000630063000000000041
0000004200000063000000000063000000004846
0000004200000000000000000063000000484600
0000004263630000000063636363000048460000
0000004200630000000063000000484546000000
0042737300634845470063000000410000000000
0042000000004100420063000000410000000000
0042000000004100420000000000410000000000
0042000000004100134545454545460000000000
0013454545454600000000000000000000000000
0000000000000000000000000000000000000000
0000000000000000000000000000000000000000
0000000000000000000000000000000000000000
0000000000000000000000000000000000000000
0000000000000000000000000000000000000000
0000000000000000000000000000000000000000
0000000000000000000000000000000000000000
0000000000000000000000000000000000000000
0000000000000000000000000000000000000000
0000000000000000000000000000000000000000
0000000000000000000000000000000000000000
0000000000000000000000000000000000000000
0000000000000000000000000000000000000000
0000000000000000000000000000000000000000
0000000000000000000000000000000000000000
0000000000000000000000000000000000000000
0000000000000000000000000000000000000000
0000000000000000000000000000000000000000
0000000000000000000000000000000000000000
0000000000000000000000000000000000000000
0000000000000000000000000000000000000000
0000000000000000000000000000000000000000
0000000000000000000000000030000000300000
0000000030000000000000000000000000000000
0000000000000000003600000000000000000000
0000000036000000000000005000500000000000
0000000000005600003800003800000000003800
0000000000000000470000000000000000000000
0000003850000000000000000000000056003600
0000000000000000000000000000000000000000
0000000000000000000000360000000000000000
0000000000000000000000000000000000000000
0000000000000000005600005000000038000000
0000000000000000000000000000000000000000
0000000038005000000000500000000000000000
0000000000000000000000000000000000000000
0000380000000000000000000038000000000000
0000005600050000000014000000000000000000
0000080000060000000000000000000000000000
0000000000000000000000000000000000000000