0000000000000000000000000000000000000000
0000000000000000000000000000000000000000
0000000000000000000000000000000000000000
0000000000000000000000000000000000000000
0000000000000000030000000000000000000000
0000000065656565656565656565650000000000
0000000065656565656565656565650000000000
0000000065656565656565656565650000000000
0000000065656565656565656565650000000000
0000000065656565656565656565656500000000
0000000065656565656565656565650600000000
0000000065656565656565656565650000000000
0000000065656565656565656565650000000000
0000000065656565656565656565650000000000
0000000065656565656565656565650000000000
0000000065656503656565656565650000000000
0000000000000000000000000000000000000000
0000000000000000000000000000000000000000
0000000000000000000000000000000000000000
0000000000000000000000000000000000000000
0000000000000000000000000000000000000000
0000000000000000000000000000000000000000
0000000000000000000000000000000000000000
0000000000000042734100000000000000000000
0000004273737373007373737373734100000000
0000004200000000000000000000004100000000
0000004200000000000000000000004100000000
0000004265656565000065656565654100000000
0000004200000000000000000000007341000000
0000004200000000000000000000000041000000
0000004200000000000000000000004846000000
0000004200000000000000000000004100000000
0000004265656565656565656565654100000000
0000004200000000000000000000004100000000
0000004200000000000000000000004100000000
0000001345454500454545454545454600000000
0000000000001345460000000000000000000000
0000000000000000000000000000000000000000
0000000000000000000000000000000000000000
0000000000000000000000000000000000000000
0000000000000000000000000000000000000000
0000000000000000000000000000000000000000
0000000000000000000000000000000000000000
0000000000000000000000000000000000000000
0000000000000000000000000000000000000000
0000000000000000000000000000000000000000
0000000000000000000000000000000000000000
0000000000000000000000000000000000000000
0000000000000000000000000000000000000000
0000000000000008000000000000000000000000
0000000000000000000000000000000000000000
0000000000080008000000000000000000000000
0000000000000000000000000000000000000000
0000000000000000000000000000000000000000
0000000000000000000000000000000000000000
0000000000000000000000000000000000000000
0000000000000000000000000000000000000000
0000000000000000000000000000000000000000
0000000000000000000000000000000000000000
0000000000000000000000000000000000000000
0000000000000000000000000000000000000000
0000000000000000000000000000000000000000
0000000000000000000000000000000000000000
0000000000000000000000000000000000000000
0000000000000000180000000000000000000000
0000000000380000000000090909090000000000
0000000000000000000009090909090000000000
0000000000000000191900000000000000000000
0000000000000000000000000000000000000000
0000000000070000000909000900001800000000
0000000000090909090909000909000000000000
0000000000000000002100000909000000000000
0000000000000000000000000000000000000000
0000000009090000000909090000000000000000
0000000009090900000909090038000000000000
0000000000000018000000000000000000000000
0000000000000000000000000000000000000000
0000000000000000000000000000000000000000
0000000000000000000000000000000000000000
0000000000000000000000000000000000000000