0000000000000000000000000000000000000000
0000000000000000000000000000000000000000
0000000000000000000000000000000000000000
0000000000000000000000000000000000000000
0000000001000000000000000000000000000000
0000000065656565656565656565650000000000
0000000065656565656565656565650000000000
0000000065656565656565656565650000000000
0000000065656565656565656565650000000000
0000000065656565656565656565650000000000
0000000065656565656565656565650000000000
0000000065656565656565656565650000000000
0000000065656565656565656565650000000000
0000000065656565656565656565650000000000
0000000065656565656565656565000000000000
0000000000000000030065000000000000000000
0000000000000000000065000000000000000000
0000000000000000000065000000000000000000
0000000000000000000000000000000000000000
0000000000000000000000000000000000000000
0000000000000000000000000000000000000000
0000000000000000000000000000000000000000
0000000000000000000000000000000000000000
0000000000000000000000000000000000000000
0000004273737373737373737373734100000000
0000004200000000000000650000004100000000
0000004200000000000000650000004100000000
0000004200000000000000656500654100000000
0000004200000000000000000000004100000000
0000004200000000000000000000004100000000
0000004200000000000000000000004100000000
0000004200000000000000656565654100000000
0000004200000000000000650000004100000000
0000004200000000000000650000004100000000
0000004200000000000000650000654100000000
0000001345454547004700484545454600000000
0000000000000013454200410000000000000000
0000000000000000004200410000000000000000
0000000000000000001345460000000000000000
0000000000000000000000000000000000000000
0000000000000000000000000000000000000000
0000000000000000000000000000000000000000
0000000000000000000000000000000000000000
0000000000000000000000000000000000000000
0000000000000000000000000000000000000000
0000000000000000000000000000000000000000
0000000000000000000000000000000000000000
0000000000000000000000000000000000000000
0000000000000000000000000000000000000000
0000000000000000000000000000000000000000
0000000000000000000000000000000000000000
0000000000000000000000000000000000000000
0000000000000000000000000000000000000000
0000000000000000000000000000000000000000
0000000000000000000000000000000000000000
0000000000000000000000000000000000000000
0000000000000000000000000000000000000000
0000000000000000000000000000000000000000
0000000000000000000000000000000000000000
0000000000000000000000000000000000000000
0000000000000000000000000000000000000000
0000000000000000000000000000000000000000
0000000000000000000000000000000000000000
0000000000000000000000000000000000000000
0000000000000000000000000000000000000000
0000000009090900000000000038000000000000
0000000009090900006833000000000000000000
0000000009090900000000000012000000000000
0000000009090000000000000000000000000000
0000000009090900000000000000000000000000
0000000009090909090900000000000000000000
0000000009090909090900000000000000000000
0000000009090909090900003800080000000000
0000000009090900000000000000060000000000
0000000009090000000000000606000000000000
0000000000000000180000000000000000000000
0000000000000000000000000000000000000000
0000000000000000000018000000000000000000
0000000000000000000000000000000000000000
0000000000000000000000000000000000000000