0000000000000000000000000000000000000000
0000000000000000000000000000000000000000
0000000000000000000000000000000000000000
0000000000000000000000000000000000000000
0000000000006565656500656500000000000000
0000000000006565656500656500000000000000
0000000000006565656565656500000000000000
0000000000006565656565006500000000000000
0000000000006565656565656500000000000000
0000000000006565656565656565000000000000
0000000000006565656565656500000000000000
0000000000006565656565656500000000000000
0000000000006565656565656500000000000000
0000000000000000006500000000000000000000
0000000000000000000000000000000000000000
0000000000000000000000000000000000000000
0000000000000000000000000000000000000000
0000000000000000000000000000000000000000
0000000000000000000000000000000000000000
0000000000000000000000000000000000000000
0000000000000000000000000000000000000000
0000000000000000000000000000000000000000
0000000000000000000000000000000000000000
0000000000427373730073737341000000000000
0000000000420000000000000041000000000000
0000000000420000000000000041000000000000
0000000000420000000000000041000000000000
0000000000420000000000000041000000000000
0000000000420000000000000073410000000000
0000000000420000000000000000410000000000
0000000000420000000000000048460000000000
0000000000420000000000000041000000000000
0000000000420000000000000041000000000000
0000000000134545470048454546000000000000
0000000000000000134546000000000000000000
0000000000000000000000000000000000000000
0000000000000000000000000000000000000000
0000000000000000000000000000000000000000
0000000000000000000000000000000000000000
0000000000000000000000000000000000000000
0000000000000000000000000000000000000000
0000000000000000000000000000000000000000
0000000000000000000000000000000000000000
0000000000000000000000000000000000000000
0000000000000000000000000000000000000000
0000000000000000000000000000000000000000
0000000000000000000000000000000000000000
0000000000000000000000000000000000000000
0000000000000000000000000000000000000000
0000000000000000000000000000000000000000
0000000000000000000000000000000000000000
0000000000000000000000000000000000000000
0000000000000000000000000000000000000000
0000000000000000000000000000000000000000
0000000000000000000000000000000000000000
0000000000000000000000000000000000000000
0000000000000000000000000000000000000000
0000000000000000000000000000000000000000
0000000000000000000000000000000000000000
0000000000000000000000000000000000000000
0000000000000000000000000000000000000000
0000000000000000000000000000000000000000
0000000000000000000000000000000000000000
0000000000000000001200000000000000000000
0000000000001900000019000000000000000000
0000000000001919191919000000000000000000
0000000000000000000000000000000000000000
0000000000000000000000202000000000000000
0000000000000000000020000000000000000000
0000000000002100000020000018000000000000
0000000000000000000020000000000000000000
0000000000000000000020000000000000000000
0000000000000000000000202000000000000000
0000000000000000001800000000000000000000
0000000000000000000000000000000000000000
0000000000000000000000000000000000000000
0000000000000000000000000000000000000000
0000000000000000000000000000000000000000
0000000000000000000000000000000000000000
0000000000000000000000000000000000000000