5555555555555555555555555555555555555555
5555555555555555555555555555555555555555
5555555459595355555555555555555555555555
5555555746465655555555555555555555555555
5555555746465655555555555555555555555555
5555555746465655555555555555555555555555
5555555160605255545959595959535555555555
5555555555555555574646464646565555555555
5555004655555555574646464646565555555555
5555005555555555574646464646565555555555
5555555555555555574646464646565554595959
5555555555555555574646464646565557464646
5555555555555555516060606060525557464646
5555555555555555555555555555555557464646
5555555555555555555555555555555557464646
5554595959595959595355555555555557464646
5557464646464646465655555555555551606060
5557464646464646465655555555555555555555
5557464646464646465655555555555555555555
5551606060606060605255555555555555555555
0000005555555500000000000000000000000000
0000000000000000000000000000000000000000
0000000000000000000000000000000000000000
0000000000000000000000000000000000000000
0000000000000000000000000000000000000000
0000000000000000000000000000000000000000
0000000000000000000000000000000000000000
0000000000000000000000000000000000000000
0000545454000000000000000000000000000000
0000545454000000000000000000000000000000
0000545400000000000000000000000000000000
0000000000000000000000000000000000000000
0000000000000000000000000000000000000000
0000000000000000000000000000000000000000
0000000000000000000000000000000000000000
0000000000000000000000000000000000000000
0000000000000000000000000000000000000000
0000000000000000000000000000000000000000
0000000000000000000000000000000000000000
0000000000000000000000000000000000000000
0000000000000000000000000000000000000000
0000000000000000000000000000000000000000
0000000000000000000000000000000000000000
0000000000000000000000000000000000000000
0000000000000000000000000000000000000000
0000000000000000000000000000000000000000
0000000000000000000000000000000000000000
0000000000000000000000000000000000000000
0000000000000000000000000000000000000000
0000000000000000000000000000000000000000
0000000000000000000000000000000000000000
0000000000000000000000000000000000000000
0000000000000000000000000000000000000000
0000000000000000000000000000000000000000
0000000000000000000000000000000000000000
0000000000000000000000000000000000000000
0000000000000000000000000000000000000000
0000000000000000000000000000000000000000
0000000000000000000000000000000000000000
0000000000000000000000000000000000000000
0000000000000000000000000000000000000000
0000000000000000000000000000000000000000
0000000000000000000000000000000000000000
0000000000000000000000000000000000000000
0000000000000000000000000000000000000000
0000000000000000000000000000000000000000
0000000000000000000000000000000000000000
0000000000000000000000000000000000000000
0000000000000000002200000000000000000000
0000000000000000000000000000000000000000
0000000000000000000000000022000000000000
0000000000000000000000000000000000000000
0000000000000000000000000000000000000000
0000000000000000000000000000000000000000
0000000000000000000000000000000000000000
0000000000000000000000000000000000000000
0000000000000000000000000000000000000000
0000000000000000000000000000000000000000
0000000000000000000000000000000000000000
0000000000000000000000000000000000000000