0000000000000000000000000000000000000000
0000000000000000000000000000000000000000
0000000000000000000000000000000000000000
0000000025252500000000000000000000000000
0000000025252500000000000000000000000000
0000000025252525252525250000000000000000
0000000000000025252525250000000000000000
0000000000000025252525250000000000000000
0000000000000025252525250000000000000000
0000000000000025252500000000000000000000
0000000000000025252500252525000000000000
0000000025252525252525252525000000000000
0000000025252525252525252525000000000000
0000000025252525000000252525000000000000
0000000025252525000000000000000000000000
0000000025252525000000000000000000000000
0000000000002500000000000000000000000000
0000000000000000000000000000000000000000
0000000000000000000000000000000000000000
0000000000000000000000000000000000000000
0000000000000000000000000000000000000000
0000000000000000000000000000000000000000
0000000000000000000000000000000000000000
0000000000000000000000000000000000000000
0000000000000000000000000000000000000000
0000000000000000000000000000000000000000
0000000000000000000000000000000000000000
0000000000000000000000000000000000000000
0000000000000000000000000000000000000000
0000000000000000000000000000000000000000
0000000000000000000000000000000000000000
0000000000000000000000000000000000000000
0000000000000000000000000000000000000000
0000000000000000000000000000000000000000
0000000000000000000000000000000000000000
0000000000000000000000000000000000000000
0000000000000000000000000000000000000000
0000000000000000000000000000000000000000
0000000000000000000000000000000000000000
0000000000000000000000000000000000000000
0000000000000000000000000000000000000000
0000000000000000000000000000000000000000
0000000000000000000000000000000000000000
0000000000000000000000000000000000000000
0000000000000000000000000000000000000000
0000000000000000000000000000000000000000
0000000000000000000000000000000000000000
0000000000000000000000000000000000000000
0000000000000000000000000000000000000000
0000000000000000000000000000000000000000
0000000000000000000000000000000000000000
0000000000000000000000000000000000000000
0000000000000000000000000000000000000000
0000000000000000000000000000000000000000
0000000000000000000000000000000000000000
0000000000000000000000000000000000000000
0000000000000000000000000000000000000000
0000000000000000000000000000000000000000
0000000000000000000000000000000000000000
0000000000000000000000000000000000000000
0000000000000000000000000000000000000000
0000000000000000000000000000000000000000
0000001414141414000000000000000000000000
0000001400000014000000000000000000000000
0000001400000014141414141400000000000000
0000001400000000000000001400000000000000
0000001414141400000000001400000000000000
0000000000001400000000001400000000000000
0000000000001400000000001400000000000000
0000000000001400000014141414140000000000
0000001414141400000014000000140000000000
0000001407000000000000000000140000000000
0000001400000000000000000000140000000000
0000001400000000141414000000140000000000
0000001400000000140014141414140000000000
0000001400000000140000000000000000000000
0000001414141514140000000000000000000000
0000000000000000000000000000000000000000
0000000000000000000000000000000000000000
0000000000000000000000000000000000000000