0000000000000000000000000000000000000000
0000000000000000000000000000000000000000
0000000000000000000000000000000000000000
0000000000000000000000000000000000000000
0000000000000000000000000000000000000000
0000000000000000000000000000000000000000
0000000000000000001700000000000000000000
0000000000001113131313130800000000000000
0000000000001407070707071500000000000000
0000000000001407070007071500000000000000
0000000000001407070707071500000000000000
0000000000001407070707071500000000000000
0000000000660707070707070766000000000000
0000000000001407070707071500000000000000
0000000000001407070707071500000000000000
0000000000001012120712120900000000000000
0000000000000000001700000000000000000000
0000000000000000000000000000000000000000
0000000000000000000000000000000000000000
0000000000000000000000000000000000000000
0000000000000000000000000000000000000000
0000000000000000000000000000000000000000
0000000000000000000000000000000000000000
0000000000000000000000000000000000000000
0000000000000000000000000000000000000000
0000000000000000000000000000000000000000
0000000000424343430043444341000000000000
0000000000420000000000000041000000000000
0000000000424700000000004841000000000000
0000000000424443430043434441000000000000
0000000000420000000000000041000000000000
0000000042430000000000000043410000000000
0000000042000000000000000000410000000000
0000000013470000000000000048460000000000
0000000000420000000000000041000000000000
0000000000420000000000000041000000000000
0000000000134545470048454546000000000000
0000000000000000134546000000000000000000
0000000000000000000000000000000000000000
0000000000000000000000000000000000000000
0000000000000000000000000000000000000000
0000000000000000000000000000000000000000
0000000000000000000000000000000000000000
0000000000000000000000000000000000000000
0000000000000000000000000000000000000000
0000000000000000000000000000000000000000
0000000000000000000000000000000000000000
0000000000000000000000000000000000000000
0000000000000000000000000000000000000000
0000000000000000000000000000000000000000
0000000000000000000000000000000000000000
0000000000000000000000000000000000000000
0000000000000000000000000000000000000000
0000000000000000000000000000000000000000
0000000000000000000000000000000000000000
0000000000000000000000000000000000000000
0000000000000000000000000000000000000000
0000000000000000000000000000000000000000
0000000000000000000000000000000000000000
0000000000000000000000000000000000000000
0000000000000000000000000000000000000000
0000000000000000000000000000000000000000
0000000000000000000000000000000000000000
0000000000000000000000000000000000000000
0000000000000000000000000000000000000000
0000000000000000000000000000000000000000
0000000000000030001200300000000000000000
0000000000000000000000000000000000000000
0000000000000000000000000000000000000000
0000000000000035301230350000000000000000
0000000000000000000000000000000000000000
0000000000000000560056000000000000000000
0000000000180000000000000018000000000000
0000000000000000560056000000000000000000
0000000000000000000000000000000000000000
0000000000000000460000470000000000000000
0000000000000000001800000000000000000000
0000000000000000000000000000000000000000
0000000000000000000000000000000000000000
0000000000000000000000000000000000000000