0000000000000000000000000000000000000000
0000000000000000000000000000000000000000
3061616161616161176161616161616261616130
3062626161616162176261616100616162616130
3061616161616161176161616100006161616130
3061000000006161176162610036006161616130
3000000000000061100861616117616161616130
3000000000000061611761616117616161616230
3000000000000061611466666609616161616130
3062000000006162611762616261616161616130
3061610036006161110961616161616161616130
3061616217616161176161610000006161616130
3061616117616162176161300000000061626130
3061626117616161176161300036000062616230
3061616117616161176261616117616161616130
3061616117616261176161616117616161616130
3061616110666612126666661315616161616130
3061616261626161616161611415616161616230
3061616161616261616161621415626161616130
3030303030303003033030300303303030303030
0000000000000000000000000000000000000000
0000000000000000000000000000000000000000
1600000000000000000000000000000000000016
1600006667000052005300003537340000000016
2300006869000000000000003331320000000016
2335373737373400000000002800270000000016
2336767676763800000000000000000000000016
2333747676753200000000000000000000000016
2328367676382700000000000000666766670016
2300333131320000000000000000687071706716
2300282600270000000000000000006869686916
2300000000000000000000353737373400000016
2300000000000000000000333131313200000016
2300000000666700000000282600262700000016
2300000000686900000000000000000000000016
2300000000000000000000000000000000000016
2300000000000000000000000000000000000016
2300000000000000000000000000000000000016
2300000000000000000000000000000000000016
1517171717171717171717170000171717171714
0000000000000000000000000000000000000000
0000000000000000000000000000000000000000
0000000000000000000000000000000000000000
0000000000000000000000000000000000000000
0000000000000000000000000000000000000000
0000000000000000000000000000000000000000
0000000000000000000000000000000000000000
0000000000000000000000000000000000000000
0000000000000000000000000000000000000000
0000000000000000000000000000000000000000
0000000000000000000000000000000000000000
0000000000000000000000000000000000000000
0000000000000000000000000000000000000000
0000000000000000000000000000000000000000
0000000000000000000000000000000000000000
0000000000000000000000000000000000000000
0000000000000000000000000000000000000000
0000000000000000000000000000000000000000
0000000000000000000000000000000000000000
0000000000000000000000000000000000000000
0000000000000000000000000000000000000000
0000000000000000000000000000000000000000
0000000000000000000000000000000000000000
0000000000090900000009090000000000000000
0000000000090900000009090000000009090000
0000000000000000000000000013000009090000
0000000000000000000000000000000009090000
0000000000000000000056006200000000000000
0000000000000000000000000000000000000000
0000000000000000000000000000000000000000
0000000013000056000000000000000000000000
0000000000100000000000000000000000000000
0000000000000000000909000000000000000000
0000000000000000000909006313630000000000
0000000000000048000000000000100000000000
0009005600000000000000005600000009090000
0009090000000000000000000000000909090000
0009090000000000000000000000000909090000
0009090900000000000000000000000000000000
0000000000000000000000000000000000000000