0000000000000000000000000000000000000000
0000000000000000000000000000000000000000
0000000000000000030300000000000000000000
0000000000000000030300000000000019000000
0000003030303030424130303030303030303030
0000003031303030434430303030303030303030
0000003030303130434430303030303030303030
0000003130303130433633333333333333333335
0000003030303030393838383838383838363636
0000003030303030303030302929303030433636
0000003030303030303030303030303030433636
0000003000303030303030300030303030433636
0000003030303030303030303030303130393838
0000003030313030303030303030303030303030
0000003031303030304234413030303030313030
0000003030303030304336443030303030303030
0000003030303030303938403030303030303030
0000003030303030303030303030303030313030
0000003030303030303030303130303030303030
0000003030303031303030303030303030303030
0000000000000000000000000000000000000000
0000000000000000000000000000000000000000
1212111212121212000012121212121212121212
1212111212121212000012121212121200121212
1212110000000000000000000000000000000000
1212110000000000000000000000000000000000
1212110000000000000000000000000000000000
1212110000000000000000000000000000000000
1212110001020000000000000000000000000000
1212110003040000000000000000000000000000
1212110000000000000000010200000000000000
1212110000000000000000030502000000000000
1212110000000000000000000304000000000000
1212110000000000000000000000000000000000
1212110000000000000000000000000000000000
1212110000010201020000000000000000000000
1212110001060506040000000000000000000000
1212110003040304000000000000000000000000
1212110000000000000000000000000000000000
1212110000000000000000000000000000000000
0000000000000000000000000000000000000000
0000000000000000000000000000000000000000
0000000000000000000000000000000000000000
0000000000000000000000000000000000000000
0000000000000000000000000000000000000000
0000000000000000000000000000000000000000
0000000000000000000000000000000000000000
0000000000000000000000000000000000000000
0000000000000000030000000000000000000000
0000000000000000000000000000000000000000
0000000000000000000000000000000000000000
0000000000000000000000000000000003000000
0000000000000000000000000000000000000000
0000000000000000000000000000000000000000
0000000000000000000000000000000000000000
0000000000000000000000000000000000000000
0000000000000000000000000000000000000000
0000000000000000000003000000000000000000
0000000000000000000000000000000000000000
0000000000000000000000000000000000000000
0000000000000000000000000000000000000000
0000000000000000000000000000000000000000
0000000000000000000000000000000000000000
0000000000000000000000000000000013000000
0000000054555055000050575750005600564800
0000000000000000000000000000000000000000
0000000000000000000010000000000000000000
0000000000000000000000000000000000000000
0000000000000000000000000000000000000000
0000000000000000000000000000000000000000
0000000000000000000000000000000000000000
0000000005000909090909000000000000000000
0000000000000909090909000000000000000000
0000000000000009090900000000000000000000
0000000000000000000000000000090900000000
0000000000000000000000000009090900000000
0000000000000000000000000909090900000000
0000000000000000000000000909090000000000
0000000000000000000000000000000000000000
0000000000000000000000000000000000000000