0000000000000000000000000000000000000000
0000000000000000000000000000000000000000
0000180000000000001800000303000000000000
0030000000000000000000000303000000303000
0030000000003600000000000303000000303000
0030303030303030303000000303000000303000
0031303030293029303030000303001800303000
0030303030302930313029304233413030302900
0030303030303030293030304336443130302900
0029303030313130423441303938403030303000
0030303030303030433640303030302930303000
0030303030303030434530303030303030293000
0030303030303030434530303030303030303000
0030302930313030394030303031303030303000
0030303030300030302930303030303031303000
0000000000000000030300000000000000000000
0000000000000000030300000000000000000000
0000000000000000030300000000000000000000
0000000000000000030300000000000000000000
0000000000000000030300000000000000000000
0000000000000000000000000000000000000000
0000000000000000000000000000000000000000
3017353737373737373409120000121211171724
1600333131313131313209120000121211000016
1600282625260026252709120000121211000016
1600000000000000000009120000121211000016
1600000000000000000008120000120007000016
1600000000000000000000000000000000000016
1600000000000000000000000000000000000016
1600000000000000000000000000000000000016
1600000000000000000000000000000000000016
1600000000000000000000000000000000000016
1600000000000000000000000000000000000016
1600000000006500000000000000000000000016
1600000000006500000000000000000000000016
1517171717171714000015171717171717171714
1012121212121211000010121212121212121212
0912121212121211000010121212121212121212
0912121212121211000010121212121212121212
0912121212121211000010121212121212121212
0000000000000000000000000000000000000000
0000000000000000000000000000000000000000
0000000000000000000000000000000000000000
0000000000000000000000000000000000000000
0000000000000000000000000000000000000000
0000000000000000000000000000000000000000
0000000100000000000000000000000000000000
0000000000000000000000000000000000000000
0000000000000000000000000000000000000000
0000000000000000000000000000000000030000
0000000000000000000000000000000000000000
0000000000000000000000000000000000000000
0000000000000000000000000000000000000000
0000000000000000000000010000000000000000
0000000300000000000000000000000000000000
0000000000000000000000000000000000000000
0000000000000000000000000000000000000000
0000000000000000000000000000000000000000
0000000000000000000000000000000000000000
0000000000000000000000000000000000000000
0000000000000000000000000000000000000000
0000000000000000000000000000000000000000
0000000000000000000000000000000000000000
0050000000000000000000000000000000090900
0005000000001300000000000000000000090900
0000000000000010000000000000000000090900
0000000000000000000000000000001300090900
0000000000000000000009090000000000000000
0000090909000000000009090000000000000000
0000090909006100000000090000000000000000
0000090909006100000000090909090000000000
0000090909006100000009090909090000000000
0000090909006000000009090909505555575000
0000000000000000000000000000000009090900
0000000000000000000000000000000009090900
0000000000000000000000000000000000000000
0000000000000000000000000000000000000000
0000000000000000000000000000000000000000
0000000000000000000000000000000000000000
0000000000000000000000000000000000000000