0000000000000000000000000000000000000000
0000000000000000000000000000000000000000
3231323232323232323132313229292942413230
3230003030303030304241323000304236443230
3031003030303030423644323030303938403230
3030003030313030433645303232303030303230
3130003030303130393840323030303232323230
3032324235413232303232303030323132323030
0000323938402932293232303030303030303030
0000000003030000000303000003030000000030
0000000003030000000303000003030000000030
6300000003030000000303000003030000000030
6363636363636363636363636363636363636363
6363006363636363636363636363636363636363
6363636363636363636363636363636363636363
6464646464646464646464646464646464646464
0000000000000000000000000000000000000000
0000000000000000000000000000000000000000
0000000000000000002929000000000000000000
0000000000000000646464640000000000000000
0000000000000000000000000000000000000000
0000000000000000000000000000000000000000
1212110000000000000000000000000000000000
1212110000000000000000000000000000000000
1212110000000000000000000000000000000000
1212110000000000000000000000000000000000
1212110000000000000000000000000000000000
1212110000000000000000000000000000000000
1212110000000000000000000000000000000000
1212111717171717171717171717171717171717
1212111212121212121212121212121212121212
1212111212121212121212121212121212121212
1212110000000000000000000000000000000000
1212110000000000000000000000000000000000
1212110000000000000000000000000000000000
1212070000000000000000000000000000000000
7272727272727272727272727272727272727272
7272727272727272301717247272727272727272
7272727272727272160000167272727272727272
7272727272727272151717147272727272727272
0000000000000000000000000000000000000000
0000000000000000000000000000000000000000
0000000000000000000000000000000000000000
0000000000000000000000000000000000000000
0000000001000000000000000000000000000000
0000000000000000000003000000000000030000
0000000000000000000000000000000000000000
0000000000000000000000000000000000000000
0000000000000000000000000000000000000000
0000000000000000000000000000000000000000
0000000000000000000000000000000000000000
0000000000000000000000000000000000000000
0000000000000000000000000000000100000000
0000000000000000000000000000000000000000
0000000000000000000000000100000000000000
0000000000000000000000000000000000000000
0000000000000000000000000000000000000000
0000000000000000000000000000000000000000
0000000000000000000000000000000000000000
0000000000000000000000000000000000000000
0000000000000000000000000000000000000000
0000000000000000000000000000000000000000
0000000000000000000000000000000000000000
0000000900090900000000000909090000000000
0000000900090909000000000909090000000000
0000000900090909000000000000000000000000
0000000900000000000000000009090000000000
0000000000005450000000090909090000000000
0000000000000000000000090900000000000000
0000000000000000000000000000000000000000
0000000000000000000000000000000000000000
0000000000000000000000000000000000000000
0000000800000000000000000000000000000000
0000000000000000000000000000000000000000
0000000000000000000000000000000000000000
0000000000000000000000000000000000000000
0000000000000000000000000000000000000000
0000000000000000000000000000000000000000
0000000000000000000000000000000000000000
0000000000000000000000000000000000000000