00000000000000000000
00000000000000000000
00000000000000000000
00000000000000001000
00000000000000001000
00000000000000001000
00000000000000001000
00000000000000001000
00000000003000001000
00000000003000001000
00000000003000001000
00000000003000001000
00000000003000004000
00000000000000000000
00000000000000000000
00000000000000000000
00000000000000000000
00000000000000000000
00000000000000000000
00000000000000000000
565656565M00012F5656
656565656M00034F6565
564343565M00000F5656
652000343M00000F3565
565200000M00000F0356
656400000M00000F0165
565200000M00000F0356
656400000M00000F0165
565200000E0HHHHD0356
65640000090BBBBA0165
56520000090BBBBA0356
65640000090BBBBA0165
56520000080BBCB70356
65640000000000000034
56520000000000000000
65640000000000000000
56520000000000000000
65640000000000000000
56520000000000000000
65641212121212121212
00000000000000000000
00000000000000000000
00000000000000000000
00000000000000000000
00000000000000000000
00000000000000000000
00000000000000000000
00000000000000000000
00000100000000000000
00000000000000000000
00000000000000000000
00000000000000000000
00000000000000000000
00000000000000000000
00000000000000000000
00000000000000000000
00000000000000100000
00000000000000000000
00000000000000000000
00000000000000000000
00000000000000000000
00000000000000000000
00000000000000000000
00000000000000000000
00000000000000000000
00000000000000000000
00000000000000000000
00000000000000000000
00000000000000000000
00000000000000000000
00000000000000000000
00000000000000000000
00000000000000000000
00000000000000000000
00000000000000000000
00000000000560000000
00000000000000000000
00000000000000000000
00000000000000000000
00000000000000000000
