IJI00001EFEFEFEFEFEF
IJI00003GHGHGHGHGHGH
IJI00000000000000000
IJI00000000000000000
IJI00000000000000000
IJI00005000000000000
IJI00006000000120000
IJI00000000000340000
IJI00000000000000000
IJI00000000000120000
IJI00000000000340000
IJI00000000000000000
IJI00000000000000000
IJI00000000000000000
IJI00000000000000000
GH400000000000000000
00000000000000000000
00000000000000000000
IJ000000000000000000
IJ121212121212121212
