0000000000000000000000000000000000000000
0000000000000000000000000000000000000000
3030302930303030304203034132303030303030
3000003030303000304303034430293032303030
3030303031303030304336364430303030303030
3030303030302931304336364430293030303030
3030303030303030303938384032293030303030
3333333341303030303030303029303030303030
3636363644303030303030303030303030303030
3636363644300000000000003030303030303030
3636363640300000000000003030313030303030
3636364430303030303030303030303031302930
3838384032303030303030302930303030303030
3030323030303030304233333341300030303030
3030303030303030303938363644303030303030
2930303030303030303030393840303030303030
3030303030303030303030303030303030303030
3030302930303130303030303030303030303030
3030303030303030303029292930303029303030
3030303030303030303030303030303030303030
0000000000000000000000000000000000000000
0000000000000000000000000000000000000000
1212121212121212121200001212121212121212
1212121212121212121200001212121212121212
0000000000000000000000000000000000000000
0000000000000000000000000000000000000000
0000000000000000000000000000000000000000
0000000000000000000000000000000000000000
0000000000000102010201020000000000000000
0000000000010605060506050200000000000000
0000000000030506050605060400000000000000
0000000000000304030403040000000000000000
0000000000000000000000000000000000000000
0000000000000000000000000000000000000000
0000000000000000000000000000000000000000
0000000000000000000000000000000000000000
0000000000000000000000000000000000000000
0000000000000000000000000000000000000000
0000000000000000000000000000000000000000
0000000000000000000000000000000000000000
0000000000000000000000000000000000000000
0000000000000000000000000000000000000000
0000000000000000000000000000000000000000
0000000000000000000000000000000000000000
0000000000010000000000000000000000000000
0000000000000000000000000000000000000000
0000000000000000000000000000000000000000
0000000000000000000000000000000000000000
0000000000000000000000000000000000000000
0000000000000000000000000000000100000000
0000000000000000000000000000000000000000
0000000000000000000000000000000000000000
0000000000000000000000000000000000000000
0000000000000000000000000000000000000000
0000000000000000000000000000000000000000
0000000100000000000001000000000000000000
0000000000000000000000000000000000000000
0000000000000000000000000000000000000000
0000000000000000000000000000000000000000
0000000000000000000000000000000000000000
0000000000000000000000000000000000000000
0000000000000000000000000000000000000000
0000000000000000000018180000000000000000
0000000000000000000000000000000000000000
0009090000000000100000000000000909090000
0009090900000000000000000000000909090000
0009090900000000000000000000000909090000
0000000000000000000000000000000909090000
0000000000000000000000000000000909090000
0000000000000000000000000000000000000000
0000000000000000000000000000000000000000
0000000000000000000000000000000000000000
0000000000000000000000000000000000000000
0000000009090909090000000000090909090000
0000000000090909090000000000090909090000
0000000000090909000000000000000909090000
0000000000000000000000000000000009000000
0000000000000000000000000000000000000000
0000000000000000000000000000000000000000
0000000000000000000000000000000000000000