0000000000000000000000000000000000000000
0000000000000000000000000000000000000000
0000000000000000000000000000000000000000
6161616161616161616161616161616161616161
6161616161616161616161616161616161616161
6130306161616161616161616161616161616161
6161323061616161616161616161616161616161
3061613061613061616161616161616161616161
6130616161616161616161616161616161616161
6161323030613030616161616161616161616161
6161616130326161616161616161616161616161
6130613030613061303061616161616161616161
3032616161616130616161616161616161616161
6161326161303061616161616161616161616161
6130613061616161616161616161616161616161
6161616161306161616161616161616161616161
3261613061616130616161616161616161616161
6161326161616161616161616161616161616161
3261613032613061616161616161616161616161
6161616161616161616161616161616161616161
0000000000000000000000000000000000000000
0000000000000000000000000000000000000000
0000000000000000000000000000000000000000
0000000000000000000000000000000000000000
0000000000000000000000000000000000000000
0000000102000000000000666700000066670000
0000000304000000010200686900000068690000
0000000000000000030400000000000066670000
0000000000000000000000000066670068690000
0000666700000000000000000068690000000000
0000686900000000000066670000000000000000
0000000000000000000068690000000000000000
0000000000000000000000000000000000666700
0000666700000102000000000066670000686900
0000680000000304006667000068690000000000
0000000000000000006869000000000000000000
0000000000000000000000000000000000000000
0000010200000066670000000000000066670000
0000030400000068690000006667000068690000
0000000000000000010200006869000000000000
0000000000000000000000000000000000000000
0000000000000000000000000000000000000000
0000000000000000000000000000000000000000
0000000000000000000000000000000000000000
0000000000000000000000000000000000000000
0000000000000000000000000000000000000000
0000000000000000000000000000000000000000
0000000000000000000000000000000000000000
0000000000000000000000000000000000000000
0000000000000000000000000000000000000000
0000000000000000000000000000000000000000
0000000000000000000000000000000000000000
0000000000000000000000000000000000000000
0000000000000000000000000000000000000000
0000000000000000000000000000000000000000
0000000000000000000000000000000000000000
0000000000000000000000000000000000000000
0000000000000000000000000000000000000000
0000000000000000000000000000000000000000
0000000000000000000000000000000000000000
0000000000000000000000000000000000000000
0000000000000000000000000000000000000000
0000000000000000000000000000000000000000
0000000000000000000000000000000000000000
0000000000000000090000000000000000000000
0000000000090000000000000000090000000000
0000000000000000000000000000000900000000
0009505050090900000000000000000000000000
0000000009000900090009000000000000000000
0000000000000000000000000000000000000000
0000000000505000000900000000005050000900
0900000009000909000000000900000900000000
0000000000000000000000000000000000000000
0000000000000000000009000000006100000000
0000000000000000000000000000006000000000
0900000900000000000000000000006000090000
0000000009005050505000090000096000000000
0000000000090000000009000000006000000000
0000000000000000000000000000000900000000
0000090000000000000000000000000000000000