0000000000000000000000000000000000000000
0000000000000000000000000000000000000000
6161616161616161616161616161616161616161
6161616161616161616161616161616161616161
6161616261616161616161616161616161616161
6161626261616161616161616161616161616161
6162616161616161616161616161616161616161
6261616161616161616161616161616161616161
6162616261616161616161616161616161616161
6161616161616161006161616161616161616161
6161616261616161616161616161616161616161
6162616261616161626161616161616161616161
6161616161626161616161626161616161616161
6162326161616161616161616161616261616161
6161323061613232616162616161616161616261
6161616161616161326161616161616161616161
6261306161616161616132616161616161616161
6161616161616161616161616161616161616162
6161626162616130306161626161616161616161
6261616161613261323261616161616261616161
0000000000000000000000000000000000000000
0000000000000000000000000000000000000000
0000000009121717171717171717171717171200
0000000009121212121212121212121212121100
6667000009121212121212121212121212121100
6869000009121212121212121212121212121100
0000666709121212121212121212121212121100
0000686909121212121212121212121212121100
0000000009121212121212121212121212121100
0066670008121212121212121212121212121100
0068690066670000006667000912121212121100
0000000068690000006869000912121212121100
0000000000000000000000000812121212120700
0000000000000000000000000066670000000000
0000000072720000000000000068690000000000
0000727272727272000000000000000066670000
0000007272727272727200000000000068690000
6667007272727272727200000000000000000000
6869000000727200007272006667000000666700
0000000000000000000000006869000000686900
0000000000000000000000000000000000000000
0000000000000000000000000000000000000000
0000000000000000000000000000000000000000
0000000000000000000000000000000000000000
0000000000000000000000000000000000000000
0000000000000000000000000000000000000000
0000000000000000000000000000000000000000
0000000000000000000000000000000000000000
0000000000000000000000000000000000000000
0000000000000000000000000000000000000000
0000000000000000000000000000000000000000
0000000000000000000000000000000000000000
0000000000000000000000000000000000000000
0000000000000000000000000000000000000000
0000000000000000000000000000000000000000
0000000000000000000000000000000000000000
0000000000000000000000000000000000000000
0000000000000000000000000000000000000000
0000000000000000000000000000000000000000
0000000000000000000000000000000000000000
0000000000000000000000000000000000000000
0000000000000000000000000000000000000000
0000000000000000000000000000000000000000
0000000000000000000000000000000000000000
0000000000000000000000000000000000000000
0000000000000000000000000000000000000000
0000000000000000000000000000000000000000
0000000000000000000000000000000000000000
0000000000000000000000000000000000000000
0000000000000000130000000000000000000000
0000000000000000000000000000000000000000
0000000000000900000000000000000000000000
0000000900000000000000000000000000000000
0000000000000000090000000000000000000000
0000090000000900000000090000000000000000
0009000000000000000000000000000000000000
0000000000000000000000000909000000000000
0000090000000000000009000000000900000000
0000000000000009090000000000000000000000
0000000900090000000900000000000000000000