0000000000000000000000000000000000000000
0000000000000000000000000000000000000000
3030303030303030303030303030303030303030
3030303000000000000000003030303030303030
3030303030303030303030313030000000003030
3030303030303030300030303000303031303030
3032303031303032303230303230303030303030
3030303032303232323232323032323030303030
3030323232323030000000000030323030303030
3032323231303030300000000000303130303030
3032323030323000000000000030323230303030
3032300030323030000000003032323230003030
3032303030333033333330333333303033333030
3032323239383830303838303030303838364430
3232313030303030000000000000303032433030
3230303030303000003030303030003232434530
3030000030003000303130303030000000304530
3030313030313030303030003030303030303837
3030303030303000303030303031303030303030
3030303030303030303030303030303030303030
0000000000000000000000000000000000000000
0000000000000000000000000000000000000000
0000000001020102010201020000000000000000
0000000003040304030403040000010201020000
0000000000000000000000000000030403040000
0000000000000000000000000000000000000000
0000000000000000000000000000000000000000
0000000000000000000000000000000000000000
0000000000000000727272727200000000000000
0000000000000000007272727272000000000000
0000000000000072727272727200000000000000
0000000000000000727272720000000000000000
0000000000000000000000000000000000000000
0000000000000000000000000000000000000000
0000000000000000000000000000000000000000
0000010200000000000000000000000000000000
0000030400000000000000000000000000000000
0000000000000000000000000000000000000000
0000000000000000000000000000000000000000
0000000000000000000000000000000000000000
0000000000000000000000000000000000000000
0000000000000000000000000000000000000000
0000000000000000000000000000000000000000
0000000000000000000000000000000000000000
0000000000000000000000000000000000000000
0000000000000000000000000000000000000000
0000000000000000000000000000000000000000
0000000000000000000000000000000000000000
0000000000000000000000000000000000000000
0000000000000000000000000000000000000000
0000000000000000000000000000000000000000
0000000000000000000000000000000000000000
0000000000000000000000000000000000000000
0000000000000000000000000000000000000000
0000000000000000000000000000000000000000
0000000000000000000000000000000000000000
0000000000000000000000000000000000000000
0000000000000000000000000000000000000000
0000000000000000000000000000000000000000
0000000000000000000000000000000000000000
0000000000000000000000000000000000000000
0000000000000000000000000000000000000000
0000000000000000000000000000000000000000
0000000000000000000000000000000000000000
0000090000000900000000000000000000000000
0000090909000009000900000009000000000000
0000090000090900000000000000505050000000
0000000900000000000000000000000000000000
0000000000000000000000000000000000000000
0000000000000000000000000000000000000000
0000000000000000000000000000000000000000
0000000900000000000000000000000000090000
0000000000000000000000000000000009090000
0000000000000000000000000000000000000000
0000000000000000095457575757550000000000
0000000000000009090000000000090000000000
0000000000090009000000000000090909000000
0000000000000000000000090000000000000000
0000000000000009000000000000000000000000
0000000000000000000000000000000000000000