0000000000000000000000000000000000000000
0000000000000000000000000000000000000000
0000000000000000000000000000000000000000
0000000000000000000000000000000000000000
0000000000000006000017000000000000000000
3131313131313100000007001200000000000000
3130303030312900000017000000000000000000
3130303030302900161607161607000000000000
3130303030313100000028000000000000000000
3131303030312900070028001700000000000000
2931313131312900170028001700000000000000
2931293129293100170028001700000000000000
2929303030292900000028000000000000000000
3229303030303200111307131300000000000000
3129303030302929101207120900000000000000
2932293030303029000007000000000000000000
2931292931293129290000000000000000000000
2929292929292929310000000000000000000000
0000000000000000000000000000000000000000
0000000000000000000000000000000000000000
0000000000000000000000000000000000000000
0000000000000000000000000000000000000000
0000000000000000000000000000000000000000
0000000000000000004040400000000000000000
4343434343434142444300434441000000000000
0000000000004142404000000041000000000000
0000000000004142434300434341000000000000
0000000000004142000000000000410000000000
0000000000004142404000404041000000000000
0000000000004142004000400041000000000000
0000000000004142524000405341000000000000
0000000000004142004000400041000000000000
0000000000004142404000404041000000000000
0000000000004343000000000041000000000000
0000000000000000000000000041000000000000
0000000000000000454700484546000000000000
0000000000000000001345460000000000000000
0000000000000000004800000000000000000000
4545454545454545454600000000000000000000
0000000000000000000000000000000000000000
0000000000000000000000000000000000000000
0000000000000000000000000000000000000000
0000000000000000000000000000000000000000
0000000000000000000000000000000000000000
0000000000000000000000000000000000000000
0000000000000000000000000000000000000000
0000000000000000000000000000000000000000
0000000000000000000000000000000000000000
0000000000000000000000000000000000000000
0000000000000000000000000100000000000000
0000000000000000000000000000000000000000
0000000000000000010000000100000000000000
0000000000000000000000000000000000000000
0000000000000000000000000000000000000000
0000000000000000000000000000000000000000
0000000000000000000000000000000000000000
0000000000000000000000000000000000000000
0000000000000000000000000000000000000000
0000000000000000000000000000000000000000
0000000000000000000000000000000000000000
0000000000000000000000000000000000000000
0000000000000000000000000000000000000000
0000000000000000000000000000000000000000
0000000000000000000000000000000000000000
0000000000000000000012000000000000000000
0000000000000000000000200700000000000000
0009090909090000000019000000000000000000
0009090909090000000000210018000000000000
0009090909000000000020000000000000000000
0000090909000000210000000000000000000000
0000000000210000000000000000000000000000
0000000000000000000000000000000000000000
0000090909000000000019000000000000000000
0000090909090000000000000000000000000000
0000090909090019000000000000000000000000
0000000909090900000015000000000000000000
0000191919000000000000000000000000000000
0000202020000000000000000000000000000000
0000000000000000000000000000000000000000
0000000000000000000000000000000000000000