00000000070000000000
00000000B78000000000
00000GGGC77GGGGG0000
000000707PQ7777F0000
00000E777PQ7777F0000
00000BDDD77DDDD80000
00000E777777777F0000
00000E777777777F0000
000077777777777F0000
00000E777777777F0000
00000E777777777F0000
00000ACCCCCCCCC90000
00000000007000000000
00000000000000000000
00000000000000000000
00000000000000000000
00000000000000000000
00000000000000000000
00000000000000000000
00000000000000000000
0000000fh0he00000000
0000fhgg000gghgge000
0000f00000000000e000
0000fdddd00ddddde000
0000fdddd00ddddde000
0000f00000000000e000
0000f00000000000e000
0000f00000000000e000
0000000000000000e000
0000f00000000000e000
0000f00000000000e000
0000f00000000000e000
0000Ciiiik0liiiij000
000000000Cij00000000
00000000000000000000
00000000000000000000
00000000000000000000
00000000000000000000
00000000000000000000
00000000000000000000
00000000000000000000
00000000000000000000
00000000000000000000
00000000000000000000
00000000000000000000
00000000000000000000
00000000010000000000
00000000000000000000
00000000000000000000
00000000000000000000
00000000000000000000
00000000000000000000
00000000000000000000
00000000000000000000
00000000000000000000
00000000000000000000
00000000000000000000
00000000000000000000
00000000000000000000
00000000000000000000
000000000C0000000000
00000000000000000000
00000000000000000000
00000000000000000000
00000000000000000000
00000000000000000000
00000000000000000000
00000000000000000000
0000G0000A0000000000
00000000000000000000
00000000000000000000
00000000000000000000
0000000000F000000000
00000000000000000000
00000000000000000000
00000000000000000000
00000000000000000000
00000000000000000000
00000000000000000000
00000000000000000000