00000000000000000000
00000000000000000000
00000000000000000000
00000000000000000000
00000003000000000000
00000003000000000000
00000000000000000000
00000000000000020000
00000000000000010000
00000000000000010000
00000000000000010000
00000000000300010000
00000000000300010000
00000000000300010000
00000000000000000000
00000000000000000000
00000000000000000000
00000000000000000000
00000000000000000000
00000000000000000000
56565656565656565656
65656434303565656565
565640IGJ00356565656
656120M0F00035656565
564340E0D00003435656
65200080700000003565
56520000000000001656
65652000IGGGGGJ03565
56564000MYaaaXF01656
64340000MWUUUVF03565
52120000MRP0OQF01656
35640000EHH0HHD03565
164000009BB0BBA01656
340000008BB0BB716565
00000000000000161656
00000000000000343565
00000000000000001656
00000000000000003565
00000000000000001656
12121212121212123565
00000000000000000000
00000000000000000000
00000000000000000000
00000000000000000000
00000000000000000000
00000000000000000000
00000100010000000000
00000000000000000000
00000000000000000000
00000000000000000000
00000000000000000000
00000000000000000000
00000000000000000000
00000000000000000000
00000000000000000000
00000000000000000000
00001000000000000000
00000000000000000000
00000000000000000000
00000000000000000000
00000000000000000000
00000000000000000000
00000000000000000000
00000000000000000000
00000000000000000000
00000000000000000000
00000000000000000000
00000000000000000000
00000000000000000000
00000000000000000000
00000000000000000000
00000000000000000000
00000000000000000000
00000000000000000000
000005C6000000000000
00000000000000000000
00000000000000000000
00000000000000000000
00000000000000000000
00000000000000000000
