12000034343434343434
34000000000000000000
12000000000000000000
34000000000000000000
12000000000000000000
34000005000000000000
12000006000000120000
34000000000000340000
12000000000000000000
34000000000000120000
12000000000000340000
34000000000000000000
12000000000000000000
34000000000000000000
12000000000000000000
34000000000000000000
12000000000000000000
34000000000000000000
12000000000000000000
34121212121212121212
