0000000000000000000000000000000000000000
0000000000000000000000000000000000000000
3231323232303232323132313229292942344130
3230303030303030303030323030304236384030
3031303030303030424130323030303940303230
4241303030303030433641303230303030303230
3940303030303130393840323030313232323230
3032323030303232303232300031303132323030
3030323030303032303232303030303030303030
0000000000000000000000000000000000000000
0000000000000000000000000000000000000000
6300000000000000180000000000000000000000
6363636363636363636363636363636363636363
6363636363636363636363636363636363636363
6363636363636363636363636363636363636363
6464646464646464646464646464646464646464
0000000000000000000000000000000000000000
0000000000000000000000000000000000000000
0000000000000000002929000000000000000000
0000000000000000646464640000003130000000
0000000000000000000000000000000000000000
0000000000000000000000000000000000000000
0000000000000000000000000000000000000000
0000000000000000000000000000000000000000
0000000000000000000000000000000000000000
0000000000000000000000000000000000000000
0000000000000000000000000000000000000000
0000000000000000000000006500000000000000
0000000000000000000000000000000000000000
1717171717171717171717171717171717171717
1212121212121212121212121212121212121212
1212121212121212001212121212121212121212
0000000000000052005300000000000000000000
0000000000000000000000000000000000000000
0000000000000000000000000000000000000000
0000000000000000000000000000000000000000
7272727272727272727272727272727272727272
7272727272727272301717247272727272727272
7272727272727272160000167272301717247272
7230172472727272151717147272230000237272
0000000000000000000000000000000000000000
0000000000000000000000000000000000000000
0000000000000000000000000000000000000000
0000000000000000000000000000000000000000
0000000003000000000000000000000000000000
0000000000000000000003000000000000030000
0000000000000000000000000000000000000000
0000000000000000000000000000000000000000
0000000000000000000000000000000000000000
0000000000000000000000000000000000000000
0000000000000000000000000000000000000000
0000000000000000000000000000000000000000
0000000000000000000000000000000000000000
0000000000000000000000000000000000000000
0000000000000000000000000000000000000000
0000000000000000000000000000000000000000
0000000000000000000000000000000000000000
0000000000000000000000000000000000000000
0000000000000000000000000000000000000000
0000000000000000000000000000000000000000
0000000000000000000000000000000000000000
0000000000000000000000000000000000000000
0000000000000000000000000000000000000000
0000090900090000000000000900090000000000
0000000900000909000000000900000000000000
0000090000090009000000000054555500000000
0000090900000000000000000000000000000000
0000005455000000000000090000000000000000
0000000000000000000000090900000000000050
0000000000000000000000000000000000000000
0000000000000000000000000000000000000000
0000000000003000130030000000000000000000
0000000000000000000000000000000000000000
0000000000000000000000000000000000000000
0000000000000000000000000000000000000000
0000000000000000000000000000000000000000
0000000000000000000000000000000000000000
0000000000000000000000000000000000000000
0000000000000000000000000000000000000000
0000000000000000000000000000000000000000