0000000000000000000000000000000000000000
0000000000000000000000000000000000000000
3030303030303030303030303030303030303030
3030303030303030303030313030303030623030
3030303030323030303030323030303030303030
3230303030303030313030303030303030303062
3030303030303030003030303030306230623030
3030303130303030303030303230303030306130
3232323030303030303030313030303030303062
3030303030303230303030303230303030306162
3030303030303030323030303030306230613030
3030303030303031303030303030303062623030
3030303030303030303030303130303030303030
3030303030303030303030303030303030306230
3031303030303030303030303030303062306230
3030313032303030303030303030306230303062
3032303030303030303230303062303030623030
3030303030303030303032303030303030303062
3030303030303030303030303030303030303030
3031303130303030303030303030303030303062
0030000000000000000000000000000000000000
0000000000000000000000000000000000000000
0102000000000000000000000000000000000000
0304000000006667000000000000000000000000
0000000000006869000000010200666701020000
0000010200000000000000030400686903040000
0000030400010200000102000000000000000000
0000000000030400000304000000000000000000
0000000000000000000000000001020066670000
0000000000000000000000000003040068690000
0102000000010200000000000102000000000000
0304000000030400000102000304000000006667
0000000000000000000304000000000102006869
0000000000000000000000000000000304000000
0000000000000000000066670000010200000000
0000000000000001020068690000030400000000
0000000102000003040000000000000000000000
0000000304000000000000000000006667010200
0000000000000000000000010200006869030400
0000000000000000000000030400000000000000
0000000000000000000000000000000000000000
0000000000000000000000000000000000000000
0000000000000000000000000000000000000000
0000000000000000000000000000000000000000
0000000000000000000000000000000000000000
0000000000000000000000000000000000000000
0000000000000000000000000000000000000000
0000000000000000000000000000000000000000
0000000000000000000000000000000000000000
0000000000000000000000000000000000000000
0000000000000000000000000000000000000000
0000000000000000000000000000000000000000
0000000000000000000000000000000000000000
0000000000000000000000000000000000000000
0000000000000000000000000000000000000000
0000000000000000000000000000000000000000
0000000000000000000000000000000000000000
0000000000000000000000000000000000000000
0000000000000000000000000000000000000000
0000000000000000000000000000000000000000
0000000000000000000000000000000000000000
0000000000000000000000000000000000000000
0000000000000000000000000909090000000000
0000000900000000000000000000000000000000
0000000000000000000900000000000000000000
0000000000000000000000000000000000000000
0000000000000000500000000009000000000000
0000000000000009000000000000000047000000
0000000000000000000000000000005000000000
0000000950000000090900000000000000000000
0000000000000000000009000000000000000000
0000505050000000000000000000000000000000
0000000000000000000000000009000000000000
0000000900000009000000000000500000000000
0000000000470000000000000909000000000000
0000000000000000000000000000000000090000
0000000000000000000000000900000000000009
0009000000005000000000000000000000000000
0000000000000000090000000000500000000000
0000000000090000000000000000090900000000