0000000000000000000000000000000000000000
0000000000000000000000000000000000000000
6161616161616161616161616161616161616161
6161616100000000000000616161616100006161
6161616100006161620061000061000061616161
0000000061006161616161616161616161616161
0000000061616161616161616161616162616100
0000000061616161610061626161616161616161
0000000061616161616161616161616161616100
0000000061616262626261616161616161616100
0000000061616161616161616162616161616100
0000000061616161616161616161616161616161
0000000061616161616161616161616161616161
0000000061616161626262616161616161616161
0000006161616161626262616161616161616161
0000006161616161616161616261616161616161
0000610061616161616161616162616161610061
6161616161616161616161616161616161616161
0000000061616161610000030361616161616161
6161616161616161616161030361616161616161
0000000000000000000000000000000000000000
0000000000000000000000000000000000000000
0000000036767676767676767676767676763800
0000000033747675317476767675317476753200
6667666728367638263676767638263676382700
7170717067333132003676767638003331326667
7071707169282627003374767532002826276870
7170717067000053002833313227000000006671
7071707169000000000028262700000000006870
7170717067000000000000000000000000006671
7071707169000000000000000000000000006870
7170717067000052000000000000000000006671
7071707169000000000000000000000000006870
7170717067000000000000000000000000006671
7071707169000000000000000000000000006870
7170717067000000000000000000000000006671
7071707169000000000000000000000000667170
6869686900000000000000000000000000686968
1717171717171717171717000017171717171717
1212121212121212121212000012121212121212
0000000000000000000000000000000000000000
0000000000000000000000000000000000000000
0000000000000000000000000000000000000000
0000000000000000000000000000000000000000
0000000000000000000000000000000000000000
0000000000000000000000000000000000000000
0000000000000000000000000000000000000000
0000000000000000000000000000000000000000
0000000000080000000000000000000000000000
0000000000000000000000000000000000000000
0000000000000000000000000000000000000000
0000000000000000000000000000080000000000
0000000000000000000000000000000000000000
0000000000000500000000000000000000000000
0000000000000000000000000000000000000000
0000000000000000000000000000000000000000
0000000000000000000000000000000000000000
0000000000000000000000000000000000000000
0000000000000000000000000000000000000000
0000000000000000000000000000000000000000
0000000000000000000000000000000000000000
0000000000000000000000000000000000000000
0000000000000000000000000000000000000000
0000000000000000000000000000000000000000
0000000000000000630000000000630000000000
0000000000000000000000000000000000000000
0000000000006300000000000000000063000000
0000000000000000004000000040000044000000
0000000000000000000000130000460000000000
0000000000005351510000000000000000000000
0000000000000000000009090000005253510000
0000000000420000000009090000000909000000
0000000000000000000000000000000909000000
0000000000000000000000000045000000000000
0000000000000000000000000000000000000000
0000000000000045000000000000004700000000
0000000000000000000909000000000000000000
0000000000000000000000000000000000000000
0000000000000000000000000000000000000000
0000000000000000000000000000000000000000