00000000000000000000
00000000000000000000
00000000000000000000
00000000000000000000
000WWWWWWWWWWWW00000
000WWVVVVVVVVWW00000
0000WTVTTVTTTW000000
0000WTTgXXfTVW000000
0000WTThaaiTTW000000
0000WTThaaiTTW000000
0000WTThaaiTTW000000
0000WTThaaiTTW000000
0000WTThaaiTTW000000
0000WWWhaaiWWW000000
00000000330000000000
00000000330000000000
00000000330000000000
00000000330000000000
00000000330000000000
00000000330000000000
56565656565656565656
65656565656565656565
56565656565656565656
65656565656565656565
565IGGGGGGGGGGJ65656
656F0000000000F56565
565F0000000000F65656
656F0000no0000F56565
565F0000000000F65656
656F0p000000q0F56565
565F0000000000F65656
656F0p000000q0F56565
565F0000000000F65656
656F0000000000F56565
565EGGGG00GGGGD65656
6569BBBB00BBBBA56565
5659BBBB00BBBBA65656
6569BBBB00BBBBA56565
5659BBBB00BBBBA65656
6569BBBB00BBBBA56565
00000000000000000000
00000000000000000000
00000000000000000000
00000000000000000000
00000000000000000000
00000000000000000000
00000000000000000000
00000000000000000000
00000000000000000000
00000000000000000000
00000000000000000000
00000000000000000000
00000000000000000000
00000000000000000000
00000000000000000000
00000000000000000000
00000000000000000000
00000000000000000000
00000000000000000000
00000000000000000000
00000000000000000000
00000000000000000000
00000000000000000000
00000000000000000000
00000000000000000000
00000000000000000000
00000000000000000000
00000000000000000000
00000000000000000000
00000000000000000000
00000000000000000000
00000000000000000000
00000000000000000000
00000000000000000000
00000000000000000000
00000000000000000000
00000000000000000000
00000000000000000000
00000000000000000000
00000000000000000000