12343434343434343434
34000000000000000001
12000000000000000003
34000000000000000000
12000012000000000000
34000034000000050000
12000000000000060001
34005000000000000003
12006000001200000000
34000000003400000000
12000000000000000000
34000000000000000000
12000000000000000000
34000000000000000001
12000000000000000003
34000000000000000000
12000000000000000000
34000000000000000000
12000000000000000000
34000012121212121212
