0000000000000000000000000000000000000000
0000000000000000000000000000000000000000
3032303030303030303030323232302930303030
3032323230323230323030303030303030303030
3030303030303030293030303030303030302930
3030303030003031303029303030303030303030
3032303030313030303030303030303030303030
3029313030303030303031293030303030303029
3232303029303030303030303230293030003030
3030303030303030303029313230303030303030
3030303030303030303130323230303031302930
3030303030303030303030303030003030303030
3030303030303030303000000000003030303230
3030303030303030303030303030303030313230
3230303029323230313030323030303029323230
3230303030303030303130323030303030323130
3230300000000030302930303030303031323030
3029303030303030323031303030303030322930
3030313030303032303230303030303030303030
3030303030293030303030303029292930303030
0000000000000000000000000000000000000000
0000000000000000000000000000000000000000
0000000000000000000000000000000000000000
0000000000000000000000010200000000000000
0000000000000000000000030400000000000000
0000000000000000000000000000000000000000
6500000000000001020000005200000000000000
0000000000000106050200000000000000000000
0000000000000304030400000000000000650000
0000010200000000000000000000000000000000
0001060502000000000000000001020000000000
0003040305020000010201020106050200000000
0000000003040000030506050605060502000000
0000000000000000000304030403040304000000
0000000000000000000000000000000000000000
6500010201020102000000000000000000000000
0000030506050604000000000000000000000000
0000000304030400000000000000000000000000
0000000000000000000000000000000000000000
0000000000000000000000000000000000000000
0000000000000000000000000000000000000000
0000000000000000000000000000000000000000
0000000100000000000000000000000000000000
0000000000000000000000000000000000000000
0000000000000000000000000000000000000000
0000000000000000000000000000000000000000
0000000000000000000000000000000000000000
0000000000000000000000000000000000000000
0000000000000000000000000000000300000000
0000000000000000000000000000000000000000
0000000000000000000000000000000000000000
0000000000000000000000000000000000000000
0000000000000000000000000000000000000000
0000000000000000000000000000000000000000
0000000000000000000000000000000000000000
0000000000000000000000000000000000000000
0000000000000000000000030000000000000000
0000000000000000000000000000000000000000
0000000000000000000000000000000000000000
0000000000000000000000000000000000000000
0000000000000000000000000000000000000000
0000000000000000000000000000000000000000
0000000000000000000000000000000000000000
0000000009000000000000000000000000000000
0009090909000000000000000000090909610000
0009090909050000000000000000090909610000
0000090900000000000000000000090909610000
0000000000000000000000000000000000610000
0000000000000000000000000000000000000000
0000000000090909090000000000000000000000
0000000000090909090000000000000000000000
0000000000000909000000000000000000000000
0000000000000909000000000000000000000000
0009090900000909000000000000000000000000
0000090000000000000000000009090900000000
0000000000000000000000000909050900000000
0000000000000000000000000909090900000000
0000000000000000000000000909090900000000
0000000000000000000909090909090900000000
0000000000000000000000000000000000000000