0000000000000000000000000000000000000000
0000000000000000000000000000000000000000
3030303030303030303030303030303030303030
3030303030303030323230303030303230303030
3030303030303030303030303030320030303030
3030303032303030303030303030303030323030
3000323030303030303030303030303030303030
3030323230303030333333333033303330303030
3030303030304330383838383838383838383038
3230303030303045303029322930303030003030
3030323030303045303029322930303030303030
3230303030304330003029000000000000003030
3030303030304345303030000000000000003030
3030303030304330303030000000000000003030
3030303030304330302930303030303030303030
3030333330333630303029302929302930303030
3838303838303040303030302929302929303030
3030303030303030303030303030303030303030
3030323030003030303030303030303030303030
3030303030303030303030303030303030303030
0000000030300000000000000000000000000000
0000000000000000000000000000000000000000
0000000000000000000000000000000000000000
0000000000000000000000000000000000000000
0000000000000000000000000000000000000000
0000000000000001020102010200000000000000
0000000000000003040304030400000000000000
0000000000000000000000000000000000000000
0000000000000000000000000000000000000000
0000000000000000000000000000000000000000
0000000000000000000000000000000000000000
0000000000000000000000353737373737340000
0000000000000000000000333131313131320000
0000010200000000000000282626002626270000
0000030400000000000000000000000000000000
0000000000000000000000000000000000000000
0000000000000000000000000000000102000000
0000000000000000005200000000000304000000
0000000000000000000000000000000000000000
0000000000000000000000000000000000000000
0000000000000000000000000000000000000000
0000000000000000000000000000000000000000
0000000000000000000000000000000000000000
0000000000000000000000000000000000000000
0000000000000000000000000000000000000000
0000000000000000000000000000000000000000
0000000000000000000000000000000000000000
0000000000000000000000000000000000000000
0000000000000000000000000000000000000000
0000000000000000000000000000000000000000
0000000000000000000000000000000000000000
0000000000000000000000000000000000000000
0000000000000000000000000000000000000000
0000000000000000000000000000000000000000
0000000000000000000000000000000000000000
0000000000000000000000000000000000000000
0000000000000000000000000000000000000000
0000000000000000000000000000000000000000
0000000000000000000000000000000000000000
0000000000000000000000000000000000000000
0000000000000000000000000000000000000000
0000000000000000000000000000000000000000
0000000000000000000000000000000000000000
0000000000000000000000000000000000000900
0000000000000000000000000000005050000900
0000000900000000000000000000000009000900
0950500009000000000000000000000000000000
0000000000000000000000000000000000000000
0009000900000000090909000909090909000000
0009090000000000090000000000000000090000
0000000000000000090000000000000000000900
0000000009000000090000000000000000000900
0009000000000000090000000000000000000900
0009000000000000090000000000120000000900
0000000000000000090000000000000000000900
0000000000000000090000000000000000000900
0000000000000000090000000000000000000900
0000090900000000090000000000000000050900
0000000009500000000909090909090909090900
0000000009090000000000000000000000000000