0000000000000000000000000000000000000000
0000000000000000000000000000000000000000
0000000000003030303030303030303130303030
0000300000303030363636363636363030303130
3030303030303030303030303030300030302930
3030313030303030303030293030323030303030
3030303030303030303030303030303029303030
3030303030003030303030303030323030303030
3030303030303030303030303032303030303030
3031303030303030303032303232303030303030
3030303030303030303232323130303030303030
3030293030303030303030303030303030303030
3031303029303030000000000030302930303030
3030303030313030300000000030303030303030
3030303030303032303000303030303030303030
3030303030303030313031303030303030303030
3030303030003030303031303029303030303030
3130303030303030323030303030303030303030
3030303030303000303030303130303030303030
3030313030303030303030303030303030303030
0000000000000000000000000000000000000000
0000000000000000000000000000000000000000
1212121212113331313131313131320000000000
1212121212072826262600262626270000000000
0000000000000000000000000000000000000000
0000000000000000000000000000000000000000
0000000102000000010201020102000000000000
0000010605020000030506050604000000000000
0000030506040102000304030400000000000000
0000000304000304000000000000000000010200
0000000000006300000000000000000000030400
0000000000000001020102010200000000010200
0000000000000003050605060502000000030400
0000000000000000030506050604000000000000
0000010201020000000305060400000000000000
0000030506050200000003040000000000000000
0000010605060400000000000000000000000000
0000030403040000000000000000000000000000
0000000000000063000000000000000000000000
0000000000000000000000000000000000006500
0000000000000000000000000000000000000000
0000000000000000000000000000000000000000
0000000000000000000000000000000000000000
0000000000000000000000000000000000000000
0000000000000000000000000000000000000000
0000000000000000000000000000000000000000
0000000000000000000000000000000000000000
0000000000000000000000000000000000000000
0000000000000000000000000000000000000000
0000000000000000000300010000030000000000
0000000000000000000000000000000000000000
0000000002000000000000000000030000000000
0000000000000000000000000000000000000000
0000000000000000000000000000000000000000
0000000000000000000000000000020000000000
0000000000000000000000000000000000000000
0000000000000000000000000000000000000000
0000000000000000000000000000000000000000
0000000000000000000000000000000000000000
0000000000000000000000000000000000000000
0000000000000000000000000000000000000000
0000000000000000000000000000000000000000
0000000000000000000000000000000000000000
0000000000000000630013630063005455000000
0000000000000000000000006105060500610000
0000000000000909000000006100000000600000
0000000000000909000000000000000000600000
0000000000000000000000000000000000600000
0000000000000000050000000000000000610000
0000000000050000000000000000000000000000
0000000000000000000000000008000000000000
0000000000000000000000000000000000000000
0000000000000000000000000000000000000000
0000000000000000000000000000000009096100
0000000000000000000000000000000009096100
0000000000000000000000000000000009096100
0000000000000000000009000000090900006100
0000000000005000000909090009090909006100
0000000000000000000909000009090909006100
0000000000000000505455555457555457570000