0000000000000000000000000000000000000000
0000000000000000000000000000000000000000
0000656565006565656565006565000000000000
0000656565656565656565656500000000000000
0000656565656565656565656565656565656565
0000656565656565656565006565656565656565
0000656565656565656565656565656565656565
0000656565656565656565656565656565656565
0000656565656565656565656565656565656565
0000656565656565656565656565656565656565
0000656565656565656565656565656565656565
0000656565656565656565656565656565656565
0000656565656565656565656565656565656565
0065656565656565656565656565656565656565
0065656565656565656565656565656565656565
0000656565656565656565656565656565656565
0000656565656565656565656565656565656565
0065656565656565656565656565656565656565
6565656565656565656565656565656565656565
6565656565656565656565656565656565656565
0000000000000000000000000000000000000000
0000000000000000000000000000000000000000
1211101212110000000000101212121212121212
1211081212070000000000081212121212121212
1211000000000000000000000000000000000000
1211000000650000000000650000006667000000
1211000000000000000000000000006869000000
1211000000000000000000000000000000000000
1211000000000000000000000000000000000000
1211000000000000000000000000000000000000
1211000000000000000000000000000000000000
1211000000000000000066676667666766670000
1211000000000000000068707170717071690000
1211000066670000000000687071707169000000
1211000068690000000000006869686900000000
1211000000000000000000000000000000000000
1211000000000000000000000000000000000000
1207000000000000000000000000000000000000
6766670000000000000000000000000000000000
6968690000000000000000000000000000000000
0000000000000000000000000000000000000000
0000000000000000000000000000000000000000
0000000000000000000000000000000000000000
0000000000000000000000000000000000000000
0000000000000000000000000000000000000000
0000000000000000000000000000000000000000
0000000000000000000000000000000000000000
0000000000000000000000000000000000000000
0000000000000000000000000000000000000000
0000000000000000000000000000000000000000
0000000000000000000000000000000000000000
0000000000000000000000000000000000000000
0000000000000000000000000000000000000000
0000000000000000000000000000000000000000
0000000000000000000000000000000000000000
0000000000000000000000000000000000000000
0000000000000000000000000000000000000000
0000000000000000000000000000000000000000
0000000000000000000000000000000000000000
0000000000000000000000000000000000000000
0000000000000000000000000000000000000000
0000000000000000000000000000000000000000
0000000000000000000000000000000000000000
0000000000005054505750000000000000000000
0000090909610808000808610000000000000000
0000090909005050495050000000000000000000
0000090909000000000000000000000000000000
0000090909010075007500010000000000000000
0000090900010000000000010000090909000000
0000090900010000000000010009090909000000
0000000000090909000000000000090909000000
0000000009090909000000000000000000000000
0000000009090909000000000000000000000000
0000000000000909090000000000000000000000
0000000000000000000000000000000000000000
0000000000000000000000000000000000000000
0000000000000000090909090000000909000000
0000000000000009090909090000090909090000
0000000000000909090000000000000909090000
0000000000000000000000000000000000000001