0000000000000000000000000000000000000000
0000000000000000000000000000000000000000
0000000065656565656565656565650000000000
0000000065656565656565656565650000000000
0000000000000000000303000000000000000000
0000000000000000000303000000000000000000
0000000000656565000303000000000000000000
0065656565656565650303656565656565656500
0065656565656565656565656565656565656500
0065656565656565656565656565656565656500
0065656565656565656565656565656565656500
0065656565656565656565656565656565656500
0065656565656565656565656565656565656500
0065656565656565656565656565656565656500
0065656565656565656565656565656565656500
0000030300000000000000000000000000000000
0000030300000000000000000000000000000000
0000030300000000000000000000000000000000
0000030300000000000000000000000000000000
0000030300000000000000000000000000000000
0000000000000000000000000000000000000000
0000000000000000000000000000000000000000
1212121600000000000000000000002312121212
1212121600000000000000000000002312121212
1212122917171724650000301717173912121212
1212121212121215170000141212121212121212
3017171717171709120000111717171717171724
1600000000000008120000070000000000000023
1600000000000000000000000000000000000023
1600000000000000000000000000000000000023
1600000000000000000000000000000000000023
1600000000000000000000000000000000000023
1600000000000000000000000000000000000023
1600000000000000000000000000000000000023
1600000000000000000000000000000000000023
1517000017171717171717171717171717171739
1012000012121212121212121212121212121212
1012000012121212121212121212121212121212
1012000012121212121212121212121212121212
1012000012121212121212121212121212121212
0000000000000000000000000000000000000000
0000000000000000000000000000000000000000
0000000000000000000000000000000000000000
0000000000000000000000000000000000000000
0000000000000000000000000000000000000000
0000000000000000000000000000000000000000
0000000000000000000000000000000000000000
0000000000000000000000000000000000000000
0000000000000000000000000006000000000000
0000000000000000000000000000000000000000
0000000000000000000000000000000000000000
0000060000000000000000000000000000000000
0000000000000000000000000000000000000000
0000000000000000000000000000000008000000
0000000000000000000000000000000000000000
0000000000000000000000000000000000000000
0000000000000000000000000000000000000000
0000000000000000000000000000000000000000
0000000000000000000000000000000000000000
0000000000000000000000000000000000000000
0000000000000000000000000000000000000000
0000000000000000000000000000000000000000
0000000000000000000000000000000000000000
0000000009090900000000000909090000000000
0000000000000000000000000000000000000000
0000000000000000000000000000000000000000
0000000000000000000000000000000000000000
0000000000000000000000000000000000000000
0009090909090000000000000000000009090000
0009090909000000000000000000000009090000
0000000909000009090009000000000909090000
0000000000000000090909090000000909090900
0000000000000000000909090009000000000000
0000000000000000000009090909000000000000
0000000000000000000000000000000000000000
0000000000000000000000000000000000000000
0000000000000000000000000000000000000000
0000000000000000000000000000000000000000
0000000000000000000000000000000000000000
0000000000000000000000000000000000000000