0000000000000000000000000000000000000000
0000000000000000000000000000000000000000
3231323232323232323132313229292942413200
3230303030303030304241323000304236443200
3031303030303030423644323030303938403200
3030303030313030433645303232303030303200
3130303030303130393840323030303232323200
3032324235413232303232303030323132323000
0000323938403232303232303030303030000000
0000000003030000000303000003030000000000
0000000003030000000303000003030000000000
6300000003030000000303000003030000636300
6363636363636363636363636363636363636300
6363636363636363636363636363636363636300
6363636363636363636363636363636363636300
6464646464646464646464646464646464646464
0000000000000000000000000000000000000000
0000000000000000000000000000000000000000
0000000000000000002929000000000000000000
0000000000000000646464640000000000000000
0000000000000000000000000000000000000000
0000000000000000000000000000000000000000
0000000000000000000000000000000000000009
0000000000000000000000000000000000000009
0000000000000000000000000000000000000009
0000000000000000000000000000000000000009
0000000000000000000000000000000000000009
0000000000000000000000000000000000000009
3024000000005200530000000000000000302409
1514171700001717170000171700001717151409
1011121200001212120000121200001212101109
0811121200001212120000121200001212080709
0000000000000000000000000000000000000009
0000000000000000000000000000000000000009
0000000000000000000000000000000000000009
0000000000000000000000000000000000000008
7272727272727272727272727272727272727272
7272727272727272301717247272727272727272
7272727272727272160000167272727272727272
7272727272727272151717147272727272727272
0000000000000000000000000000000000000000
0000000000000000000000000000000000000000
0000000000000000000000000000000000000000
0000000000000000000000000000000000000000
0000000003000000000000000000000000000000
0000000000000000000003000000000000030000
0000000000000000000000000000000000000000
0000000000000000000000000000000000000000
0000000000000000000000000000000000000000
0000000000000000000000000000000000000000
0000000000000000000000000000000000000000
0000000000000000000000000000000000000000
0000000000000000000000000000000000000000
0000000000000000000000000000000000000000
0000000000000000000000000000000000000000
0000000000000000000000000000000000000000
0000000000000000000000000000000000000000
0000000000000000000000000000000000000000
0000000000000000000000000000000000000000
0000000000000000000000000000000000000000
0000000000000000000000000000000000000000
0000000000000000000000000000000000000000
0000000000000000000000000000000000000000
0000090900090900000000000909090000000000
0000090900090909000000000909090000000000
0000090900090909000000000000000000000000
0000090900000000000000000009090000000000
0000000000000000000000090909090000000000
0000000000000000000000090900000000000000
0000000000000000000000000000000000000000
0000000000000000000000000000000000000000
0000000000000000000000000000000000000000
0000000000000000000000000000000000050000
0000050000000000000000000000050000000000
0000000500000005000005000000000000000000
0000000000000000000000000000000000000000
0000000000000000000000000000000000000000
0000000000000000000000000000000000000000
0000000000000000000000000000000000000000
0000000000000000000000000000000000000000