0000000000000000000000000000000000000000
0000000000000000000000000000000000000000
3030303030303030303030303000303030310000
3030303030303030313030303000303030300000
3031303030303030303030303000303130310000
3030303030303030303031303000303030300000
3030303030303030303030303000000303000000
3030313030303030303030303000000303000000
3030303031303030303030303000000303000000
3030303000303031303130303000000303000000
3030303030303042413030303000000303000000
4241303031303139403030303000000303000000
3940303130303030303030303030313030303000
3030303030313030303030303030303030313000
3130303030303030313030303030303030303000
3030303030303030303031303030303030303000
3030303030303030313030303030303030303000
3030303030303030303042343441303030303000
3030303030303030303039383840303030303000
3030303030303030303030303030303030303000
0000000000000000000000000000000000000000
0000000000000000000000000000000000000000
0065030506050604030506050230171717172410
0000000305060502000305060416000000001610
0000000106050605020003040016000000001610
0000000304030403040000000016000000001610
0000000000000000000000000015170000171410
0000000000000000000000000009120000121110
0000000000000000000000000009120000121110
0000000000000000000000000009120000121110
0000000000000000000000000009120000121110
0000000000000000000000000008120000120710
0000000000000000000000000000000000000010
0000000000000000000000000000000000000010
0000000000000000000000000000000000000010
0000000000000000000000000000000000000010
0000000000000000000000000000000000000010
0000000000000000000000000000000000000010
0000000000000000000000000000000000650010
0000000000000000000000000000000000000010
0000000000000000000000000000000000000000
0000000000000000000000000000000000000000
0000000000000000000000000000000000000000
0000000000000000000000000000010000010000
0000000000000000000000000000000000000000
0000000000000000000000000000000000000000
0000000000000000000000000000000000000000
0000000000000000000000000000000000000000
0000000000000000000000000000000000000000
0000000000000000000000000000000000000000
0000000000000000000003000000000000000000
0000000000000000000000000000000000000000
0000000000000000000000000000000000000000
0000000000000300000000000000000000000000
0000000000000000000000000000000000000000
0000000000000000000000000000000000000000
0000000000000000000000000000000000000000
0000000000000000000000000000000000000000
0000000000000000000000000000000000000000
0000000000000000000000000000000000000000
0000000000000000000000000000000000000000
0000000000000000000000000000000000000000
0000000000000000000000000000000000000000
0000000000000000000000000000000606000000
0000000000000000000000000000000000000000
0000000000000000000000000000000000000000
0000090000000000000000000000000000000000
0009090009090900090909090000000000000000
0009090009090900090909090000000000000000
0009090009090900000909000000000000000000
0009090009090900000000000000000000000000
0000000000000000000000000000000000000000
0000000054500000090909000000000000000000
0000090900000000090909505757500000000000
0000090900000000000909000909000000610000
0000090909090909000000090909090909610000
0000090909090909090000090909090909610000
0000000000000000000000000000000000600000
0000000000545454550000000000000000000000
0000000000000000000000000000000000000000