0000000000000000000000000000000000000000
0000000000000000000000000000000000000000
0000000000000000000000000000000000000000
0000000000000000006500000000000000000000
6565656565656565656565656565650000000000
6565656565656565656565656565650000000000
6565656565656565656565656565650000000000
6565656565656565656565656565650000000000
6565656565656565656565656565650000000000
6565656565656565656565656565650065650000
6565656565656565656565656565650000000000
6565656565656565656565656565650000000000
6565656565656565656565656565650000000000
6565656565656565656565656565650000000000
6565656565656565656565656565650000000000
6565656565656565656565656565650000000000
6565656565656565656565656565650000000000
6565656565656565656565656565656500000000
6565656565656565656565656565656565656565
0065656565656565656565656565656565656565
0000000000000000000000000000000000000000
0000000000000000000000000000000000000000
1212121212121212121212121212121012121212
1212121212121212121212121212121012121212
0000006667666766670000000000001012121212
0000006870717071706700000000001012121212
0000006671707170716900000000001012121212
0000006870717071706700000000001012121212
0000000068696870716900000000001012121212
0000000000000068706700000000001012121212
0000000000000000686900000000001012121212
0000000000000066676667666700001012121212
0000000000000068707170716900001012121212
0000000000000000686968690000001012121212
0000000000666766676667000000001012121212
0000000000686968696869000000001012121212
0000000000000000000000000000001012121212
0000000000000000000000000000000812121212
0000000000000000000000000000000000006667
6500000000000000000000000000000000006869
0000000000000000000000000000000000000000
0000000000000000000000000000000000000000
0000000000000000000000000000000000000000
0000000000000000000000000000000000000000
0000000000000000000000000000000000000000
0000000000000000000000080000000000000000
0000000000000000000000000000000000000000
0000000000000000000000000000000000000000
0000000000000000000000000000000000000000
0000000000000000000000000000000000000000
0000000000000000000000000000000000000000
0000000000000000000000000000070000000000
0000000000000000000000000000000000000000
0000000007000000000000000000000000000000
0000000000000000000000000000000000000000
0000000000000000000000000000000000000000
0000000000000000000000000000000000000000
0000000000000000000800000000000000000000
0000000000000000000000000000000000000000
0000000000000000000000000000000000000000
0000000000000000000000000000000000000000
0000000000000000000000000000000000000000
0000000000000000000000000000000000000000
0000000000000000000000000000000000000000
0000000000000000000000000006000000000000
0000000000000000000000000000000000000000
0000000000000000000000000909000000000000
0000000000000000000000090909000000000000
0000000000000000000000090909000000000000
0000090909000000000000090909000000000000
0000090909090000000006000000000000000000
0000000909090000000000000000000000000000
0000000009090000000000000000000000000000
0000000000000000000000000000000000000000
0000000000000000000000000000000000000000
0009090000000000000000000000090000000000
0000090909090000000000000909090000000000
0000000909090000000000090909090000000000
0000000009000000000000090909000000000000
0000000000000000000000000000000000000000