0000000000000000000000000000000000000000
0000000000000000000000000000000000000000
6565656565656565656565656565656565656565
6565656565656565656565656565656565656565
6565656565656565656565656565656565656565
6565656565656565656565656565656565656565
6565656565656565656565656565656565656565
6565656565656565656565656565656565656565
6565656565656565656565656565656565656565
6565656565656565656565656565656565656565
6565656565656565656565656565656565656565
6565656565656565656565656565656565656565
6565656565656565656565656565656565656565
6565656565656565656565656565656565656565
6565656565656565656565656565656565656565
6565656565656565656565656565656565656565
6565656565656565656565656565656565656565
6565656565656565656565656565656565656565
6565656565656565656565656565656565656565
6565656565656565656565656565656565656565
0000000000000000000000000000000000000000
0000000000000000000000000000000000000000
0000000000000000000000000000000000006667
6500000000000000000000000000000000667169
0065000000000000000000000000000000687067
0000000000666700000000000000000000667169
0000000000687067000000000000000000686900
0000000000006869000000000000000000006566
0000000000000000000000000000000000006568
0000000000000000000000000000666700006500
6565000000000000006667000000686900006500
6500000000000000006869000000000000006565
6500000065000000000000000000000000006667
6500000065000000000000000000000000006869
6500000065000000000000000000000000000065
6565656565000000000000000000000000000065
0000666700000000000000000000000000000065
0000688067000000000000000000000000000065
0000668180670000006667000000000066670065
0000686968690000006869000000006681690065
0000000000000000000000000000000000000000
0000000000000000000000000000000000000000
0000000000000000000000000000000000000000
0000000000000000000000000000000000000000
0000000100000000000000000000010000000000
0000000000000000000000000000000000000000
0000000000000000000000000000000000000000
0000000000000000000000000000000000000000
0000000000000000000000000100000000000000
0000000000000000000000000000000000000000
0000000000030000000000000000000000000000
0000000000000000000000000000000000000000
0000000000000000000000000000000000000000
0000000000000000000300000000000000000000
0000000000000000000000000000000000000000
0000000000000000000000000000000000000000
0000000000000000000000000000000000000000
0000000000000000000000000000000000000000
0000000000000000000000000000000000000000
0000000000000000000000000000000000000000
0000000000000000000000000000000000000000
0000000000000000000000000000000000000000
0000000000000000000000000000000000000000
0000000000000000000000000000000000000000
0000000000000000000000000000000000000000
0000610000000000000000000000000000000000
0000610000000000000000010101000000000000
0000610000000000000000000000000000000000
0000610000000000000000000000000000000000
0000610000000000000000000000000000000000
0000610000000000000000000000000000000000
0009090900000000000000000000000000000000
0009090900000000000000000000000000000000
0009090900000000000000545450550000000000
0009090900000000000000090909090000000900
0000000000000000000000090909090000000900
0000000000000000000000545450550000000900
0000000000000000000000000000000000000900
0000000000000000000000000000000000000900
0000000000000000000000000000000000000900