0000000000000000000000000000000000000000
0000000000000000000000000000000000000000
6565656565656565656565656565656565656565
6565656565656565656565656565656565656565
6565656565656565656565656565656565656565
6565656565656565656565656565656565656565
6565656565656565656565656565656565656565
6565656565656565656565656565656565656565
6565656565656565656565656565656565656565
6565656565656565656565656565656565656565
6565656565656565656565656565656565656565
6565656565656565656565656565656565656565
6565656565656565656565656565656565656565
6565656565656565656565656565656565656565
6565656565656565656565656565656565656565
6565656565656565656565656565656565656565
6565656565656565656565656565656565656565
6565656565656565656565656565656565656565
6565656565656565656565656565656565030365
6565656565656565656565656565656565656565
0000000000000065650000000000000000000000
0000000000000000000000000000000000000000
6671690000000065656565656565656565656667
8169000000650000000000006500650000006880
6900006500656565656565006500650065000068
0000006500650000000065006565000065000000
0000006500650065000065000000650065000000
0000006500650065000065656565650065000000
0000006500000065000065000000000065000000
0000006565656565000065006565656565000000
0000006500006500000000006500000065000000
0000006500656565656565656500000065000000
0000006500650000000000000000000065000000
0000006500650065656565656565650065000000
0000006500650000000000000000650065000000
0000006500000000000000000000650065000000
0000006565656565656565656565650065000000
0000000000000000000000000000000065000000
0000000000000000000000000000000065000000
6500000000000000000000000000000000000065
0000000000000000000000000000000000000000
0000000000000000000000000000000000000000
0000000000000000000000000000000000000000
0000000000000000000000000000000000000000
0000000000000000000000000000000000000000
0000000000000000000000000000000000000000
0000000000000000000000000000000000000000
0000000000000000000000000000000000000000
0000000000000000000000000000000000000000
0000000000000000000000000000000000000000
0000000000000000000000000000000000000000
0000000000000000000000000000000000000000
0000000000000000000000000000000000000000
0000000000000000000000000000000000000000
0000000000000000000000000000000000000000
0000000000000000000000000000000000000000
0000000000000000000000000000000000000000
0000000000000000000000000000000000000000
0000000000000000000000000000000000000000
0000000000000000000000000000000000000000
0000000000000000000000000000000000000000
0000000000000000000000000000000000000000
0000000000000000000000000000000000000000
0000000000000000000000000000000000000000
0000000000000000000000000000000000000000
6100000000000000000000000000000000000061
6100000000000000000000000000000000000061
6100000000000000000000000000000000000061
6100000000000000000000000000000000000061
6100000000000000000000000000000000000061
6100000000000000000000000000000000000061
6100000000000000000000000000000000000061
6100000000000000000000000000000000000061
6100000000000000000000000000000000000061
6100000000000000000000000000000000000061
6100000000000000000000000000000000000061
6100000000000000000000000000000000000061
6100000000000000000000000000000000000061
6100000000000000000000000000000000000061
0054545454545454505050505054545454545400