0000000000000000000000000000000000000000
0000000000000000000000000000000000000000
0000000000000000000000000000000000000000
0000000000000303000000000000000000000000
0000000000006565000000000000000000000000
0000000065656565656565006565650000000000
0000000065656565656565006565650000000000
0000000065656565656565006565650000000000
0000000065656565656565006565650000000000
0000000065656565656565006565650000000000
0000000065656565656565006565650000000000
0000000000000000000000000000000000000000
0000000000000000000303000000000000000000
0000000000000000000000000000000000000000
0000000000000000000000000000000000000000
0000000000000000000000000000000000000000
0000000000000000000000000000000000000000
0000000065656565656565656565656500000000
0000000065656565656565656565656500000000
0000000000000000000000000000000000000000
0000000000000000000000000000000000000000
0000000000000000000000000000000000000000
0000000000000000000000000000000000000000
0000000000420000410000000000000000000000
0000004273730000737373737373734100000000
0000004200000000000000000000004100000000
0000004200000000000000000000004100000000
0000004200000000000000000000004100000000
0000004200000000000000000000004100000000
0000004200000000000000000000004100000000
0000004200000000000000000000004100000000
0000001345454545470000484545454600000000
0000000000000000420000410000000000000000
0000000000000000134545460000000000000000
0000000000000000000000000000000000000000
0000000000000000000000000000000000000000
0000004273737373737373737373737341000000
0000004200000000000000000000000041000000
0000004200000000000000000000000041000000
0000001345454545454545454545454546000000
0000000000000000000000000000000000000000
0000000000000000000000000000000000000000
0000000000000000000000000000000000000000
0000000000000000000000000000000000000000
0000000000000000000000000000000000000000
0000000000000000000000000000000000000000
0000000000000000000000000000000000000000
0000000000000000000000000000000000000000
0000000000050000000200000000000000000000
0000000000000000000000000000000000000000
0000000000000000000000000000000000000000
0000000000000000000000000000000000000000
0000000000000000000000000000000000000000
0000000000000000000000000000000000000000
0000000000000000000000000000000000000000
0000000000000000000000000000000000000000
0000000000000000000000000000000000000000
0000000000000000000000000000000000000000
0000000000000700000007000000000000000000
0000000000000000000000000000000000000000
0000000000000000000000000000000000000000
0000000000000000000000000000000000000000
0000000000000000000000000000000000000000
0000000000000000000000000000000000000000
0000000000300000300000000000000000000000
0000000000000000000000000000000000000000
0000000000000000000000000000210000000000
0000000000000000000000000000000000000000
0000000000000000000000000000000000000000
0000000000000000000000000000000000000000
0000000038000000000000000000000000000000
0000000000000000001919000000000000000000
0000000000000000000000000000000000000000
0000000000000000000000000000000000000000
0000000000000000000000000000000000000000
0000000000000000000000000000000000000000
0000000000003000003000003000003000000000
0000000000000000000000000019191900000000
0000000021000000000000000019380000000000
0000000000000000000000000000000000000000