00070000000000000000
00070000000000000000
00070000000000000000
00070000000000000000
00070000000000000000
00070000000000000000
00070000000000000000
00070000000000000000
00070000000000000000
00070000000000000000
00070000000000000000
000D8888888888888888
00000000000000000000
00000000000000000000
00000000000000000000
00000000000000000000
00000000000000000000
00000000000000000000
00000000000000000000
00000000000000000000
