00000000000000070000
00000000000000070000
00000000000000070000
00000000000000070000
00000000000000070000
00000000000000070000
00000000000000070000
00000000000000070000
00000000000000070000
00000000000000070000
00000000000000070000
888888888888888A0000
00000000000000000000
00000000000000000000
00000000000000000000
00000000000000000000
00000000000000000000
00000000000000000000
00000000000000000000
00000000000000000000
