0000000000000000000000000000000000000000
0000000000000000000000000000000000000000
0000000000000000000000000000000000000000
0000000000000000000000000000000000000000
0000000000000000000000000000000000000000
0000000000212525232323231800000000000000
0000000000242525252525252500000000000000
0000000000242525252525252600000000000000
0000000000242525252522252600000000000000
0000000000242525252525252600000000000000
0000000000242525252525252600000000000000
0000000000242525252525252500000000000000
0000000000242525252525252500000000000000
0000000000242525252525252500000000000000
0000000000202222222222252500000000000000
0000000000000000252500000000000000000000
0000000000000000000000000000000000000000
0000000000000000000000000000000000000000
0000000000000000000000000000000000000000
0000000000000000000000000000000000000000
0000000000000000000000000000000000000000
0000000000000000000000000000000000000000
0000000000000000000000000000000000000000
0000000040404040404040404040400000000000
0000000040575757575757575740400000000000
0000000040000000690000000040000000000000
0000000040000069000000000040000000000000
0000000040000069000000000040000000000000
0000000040696969006900690040000000000000
0000000040696969696900690040000000000000
0000000040000000006900690040000000000000
0000000040000000006900690040000000000000
0000000040696969696900690040000000000000
0000000040000000000000690040000000000000
0000000040000000000069000040000000000000
0000000040404040000040404040000000000000
0000000000000040404040000000000000000000
0000000000000000000000000000000000000000
0000000000000000000000000000000000000000
0000000000000000000000000000000000000000
0000000000000000000000000000000000000000
0000000000000000000000000000000000000000
0000000000000000000000000000000000000000
0000000000000000000000000000000000000000
0000000000000000000000000000000000000000
0000000000000000000000000000000000000000
0000000000000000000000000000000000000000
0000000000000100000000000000000000000000
0000000000000000000000000000000000000000
0000000000000000000000000000000000000000
0000000000000000000000000000000000000000
0000000000010000010000000000000000000000
0000000000000000000000000000000000000000
0000000000000000000000000000000000000000
0000000000000000000000000000000000000000
0000000000000000000000000000000000000000
0000000000000000000000000000000000000000
0000000000000000000000000000000000000000
0000000000000000000000000000000000000000
0000000000000000000000000000000000000000
0000000000000000000000000000000000000000
0000000000000000000000000000000000000000
0000000000000000000000000000000000000000
0000000000000000000000000000000000000000
0000000000003700300035000000000000000000
0000000000000000000000000000000000000000
0000000000000000000008000000000000000000
0000000000380000000000000000000000000000
0000000000000000000000000000000000000000
0000000000000000000038003800000000000000
0000000000380000380000000000000000000000
0000000000000000000000003800000000000000
0000000000000000000000003800000000000000
0000000000000000000000000000000000000000
0000000000380000000000380000000000000000
0000000000000000181800000000000000000000
0000000000000000000000000000000000000000
0000000000000000000000000000000000000000
0000000000000000000000000000000000000000
0000000000000000000000000000000000000000