0000000000000000000000000000000000000000
0000000000000000000000000000000000000000
0000000000000000000000000000000000000000
0000000000000000000000000000000000000000
0000000000000003030000000000000000000000
0000000000070766660707070707000000000000
0000000000070707070707070707000000000000
0000000000070707070707070707000000000000
0000000000070707070707070707000000000000
0000000000070707070707070707000000000000
0000000000070707070707070707000000000000
0000000000070707070707070707000000000000
0000000000070707070707070707000000000000
0000000000660766660707070707000000000000
0000000000000000666600000000000000000000
0000000000000000000000000000000000000000
0000000000000000000000000000000000000000
0000000000000000000000000000000000000000
0000000000000000000000000000000000000000
0000000000000000000000000000000000000000
1313131313131313131313131313131313131300
0000000000000000000000000000000000000000
0000000000000000000000000000000000000000
0000000000000000000000000000000000000000
0000000073737300007373737373730000000000
0000000073000000000000000000730000000000
0000000073000000000000000000730000000000
0000000073000000000000000000730000000000
0000000073000000000000000000730000000000
0000000073000000000000000000730000000000
0000000073000000000000000000730000000000
0000000073000000000000000000730000000000
0000000073000000000000000000730000000000
0000000073000000000000000000730000000000
0000000073737373000073737373730000000000
0000000000000000000000000000000000000000
0000000000000000000000000000000000000000
0000000000000000000000000000000000000000
0000000000000000000000000000000000000000
0000000000000000000000000000000000000000
0000000000000000000000000000000000000000
0000000000000000000000000000000000000000
0000000000000000000000000000000000000000
0000000000000000000000000000000000000000
0000000000000000000000000000000000000000
0000000000000000000000000000000000000000
0000000000000000000000000000000000000000
0000000000000000000000000000000000000000
0000000000000000000000000000000000000000
0000000000000000000000000000000000000000
0000000000000000000000000000000000000000
0000000000000000000000000000000000000000
0000000000000000000000000000000000000000
0000000000000000000000000000000000000000
0000000000000000000000000000000000000000
0000000000000000000000000000000000000000
0000000000000000000000000000000000000000
0000000000000000000000000000000000000000
0000000000000000000000000000000000000000
0000000000000000000000000000000000000000
1414141414141414141414141414141414141414
1414141414141414141414141414141414141414
1414141414141414141414141414141414141414
1414141414141414141414141414141414141414
1414141400000000000000000000001414141414
1414141400003000003000190038001414141414
1414141400000000006833190000001414141414
1414141400000000000000191903001414141414
1414141400000000000000000000001414141414
1414141400000000000000000000001414141414
1414141400000000000000000000001414141414
1414141400000000000000191919001414141414
1414141400000000000000193800001414141414
1414141400000000000000190608001414141414
1414141400000000181800000000001414141414
1414141414141414141414141414141414141414
1414141414141414141414141414141414141414
1414141414141414141414141414141414141414
1414141414141414141414141414141414141414
1414141414141414141414141414141414141414