0000000000000000000000000000000000000000
0000000000000000000000000000000000000000
0000000000000000000000000000000000000000
0000000000000000036600000000000000000000
0000000000656565656565656565650000000000
0000000000656565656565656565650000000000
0000000000656565656565656565650000000000
0000000000656565656565656565650000000000
0000000000656565656565656565650000000000
0000000065656565656565656565650000000000
0000000066656565656565656565650000000000
0000000000656565656565656565650000000000
0000000000656565656565666565650000000000
0000000000656565656565656565650000000000
0000000000656565656565656565650000000000
0000000000000000000000000000000000000000
0000000000000000000000000000000000000000
0000000000000000000000000000000000000000
0000000000000000000000000000000000000000
0000000000000000000000000000000000000000
0000000000000000000000000000000000000000
0000000000000000000000000000000000000000
0000000000000000000000000000000000000000
0000000042737373007373737373734100000000
0000000042000000000000000000004100000000
0000000042000000000000000000004100000000
0000000042000000000000656565654100000000
0000000042000000000000650000004100000000
0000000042000000000000650000004100000000
0000004000000000000000650000004100000000
0000000042000000000000650000004100000000
0000000042000000000000650000004100000000
0000000042000000000000650000004100000000
0000000042000000000000650000004100000000
0000000042000000000000000000004100000000
0000000013454545454545454545454600000000
0000000000000000000000000000000000000000
0000000000000000000000000000000000000000
0000000000000000000000000000000000000000
0000000000000000000000000000000000000000
0000000000000000000000000000000000000000
0000000000000000000000000000000000000000
0000000000000000000000000000000000000000
0000000000000000000000000000000000000000
0000000000000000000000000000000000000000
0000000000000000000000000000000000000000
0000000000000000000000000000000000000000
0000000000000000000000000000000000000000
0000000000000000000000000000000000000000
0000000000000000000000000400000000000000
0000000000000000000000000000000000000000
0000000000000000000000000000000000000000
0000000000000000000000000000040000000000
0000000000000000000000000000000000000000
0000000000000000000000000000000000000000
0000000000000000000000000000000000000000
0000000000000000000000000000000000000000
0000000000000000000000000000000000000000
0000000000000000000000000000000000000000
0000000000000000000000000000000000000000
1414141414141414141414141414141414141414
1414141414141414141414141414141414141414
1414141414141414141414141414141414141414
1414141400000030183000000000000014141414
1414141400000000000000000000000014141414
1414141400000000000000000000000014141414
1414141400191919191919000000000014141414
1414141400000000000000000000210014141414
1414141400000000000000000000000014141414
1414141418000000000000000000000014141414
1414141400000000000000000000000014141414
1414141400000000000000000000000014141414
1414141400000000000000000000000014141414
1414141400000000000000000000000014141414
1414141400000000000000000000000014141414
1414141400000000000000000000000014141414
1414141414141414141414141414141414141414
1414141414141414141414141414141414141414
1414141414141414141414141414141414141414
1414141414141414141414141414141414141414