0000000000000000000000000000000000000000
0000000000000000000000000000000000000000
0000000000000000000000000000000000000000
0000000000000000000000000000000000000000
0000000000000000000000000000000000000000
0000000000656565656565656565656500000000
0000000000656565656565656565656500000000
0000000000656565656565656565656500000000
0000000000656565656565656565656500000000
0000000065656565656565656565656500000000
0000000065656565656565656565656500000000
0000000000656565656565656565656500000000
0000000000656565656565656565656500000000
0000000000656565656565656565656500000000
0000000000656565656565656565656500000000
0000000000000000036500000000000000000000
0000000000000000000000000000000000000000
0000000000000000000000000000000000000000
0000000000000000000000000000000000000000
0000000000000000000000000000000000000000
0000000000000000000000000000000000000000
0000000000000000000000000000000000000000
0000000000000000000000000000000000000000
0000000000000000000000000000000000000000
0000000042737373737373737373737341000000
0000000042006500000000000000000041000000
0000000042006500000000000000000041000000
0000000042006500000000000000000041000000
0000000042006500000000000000000041000000
0000000042006500000000000000000041000000
0000004000006500000000000000000041000000
0000000042006500000000000000000041000000
0000000042656500000000000000000041000000
0000000042000000000000000000000041000000
0000000042000000000000000000000041000000
0000000013454545004545454545454546000000
0000000000000000400000000000000000000000
0000000000000000000000000000000000000000
0000000000000000000000000000000000000000
0000000000000000000000000000000000000000
0000000000000000000000000000000000000000
0000000000000000000000000000000000000000
0000000000000000000000000000000000000000
0000000000000000000000000000000000000000
0000000000000000000000000000000000000000
0000000000000000000000000500000000000000
0000000000000000000000000005000000000000
0000000000000000000000000000000000000000
0000000000000000000000000000080400000000
0000000000000000000000000000000000000000
0000000000000000000000000000000000000000
0000000000000000000000000000000000000000
0000000000000000000000000000000000000000
0000000000000000000000000000000000000000
0000000000000000000000000000000000000000
0000000000000000000000000000000000000000
0000000000000000000000000000000000000000
0000000000000000000000000000000000000000
0000000000000000000000000000000000000000
0000000000000000000000000000000000000000
0000000000000000000000000000000000000000
0000000000000000000000000000000000000000
0000000000000000000000000000000000000000
0000000000000000000000000000000000000000
0000000000300000000000000000003000000000
0000000000380000000000090909093800000000
0000000000000000000000090909090900000000
0000000000000000000000090909090900000000
0000000000000000000000090909090900000000
0000000000000000000000000000000000000000
0000000018000000000000000000000000000000
0000000000000000000000000000000000000000
0000000000000000000000000000000000000000
0000000000000000000000000000000000000000
0000000000000000000000000000000000000000
0000000000000000180000000000000000000000
0000000000000000000000000000000000000000
0000000000000000000000000000000000000000
0000000000000000000000000000000000000000
0000000000000000000000000000000000000000