0000000000000000000000000000000000000000
0000000000000000000000000000000000000000
0000000000000000000000000000000000000000
0000000000000000000000000000000000000000
0000000000000066660000000000000000000000
0000000000666666666666666666666600000000
0000000000666666666666666666666600000000
0000000000666666666666666666666600000000
0000000000666666666666666666666600000000
0000000000666666666666666666666666000000
0000000000666666666666666666666666000000
0000000000666666666666666666666600000000
0000000000666666666666666666666600000000
0000000000666666666666666666666600000000
0000000000666666666666666666666600000000
0000000000000000000000000000000000000000
0000000000000000000000000000000000000000
0000000000000000000000000000000000000000
0000000000000000000000000000000000000000
0000000000000000000000000000000000000000
0000000000000000000000000000000000000000
0000000000000000000000000000000000000000
0000000000000000000000000000000000000000
0000000000000000000000000000000000000000
0000000073737300007373737373737373000000
0000000073000000000000000000000073000000
0000000073000000000000000000000073000000
0000000073000000000000000000000073000000
0000000073000000000000000000000073000000
0000000073000000000000000000000000000000
0000000073000000000000000000000000000000
0000000073000000000000000000000073000000
0000000073000000000000000000000073000000
0000000073000000000000000000000073000000
0000000073000000000000000000000073000000
0000000073737373737373737373737373000000
0000000000000000000000000000000000000000
0000000000000000000000000000000000000000
0000000000000000000000000000000000000000
0000000000000000000000000000000000000000
0000000000000000000000000000000000000000
0000000000000000000000000000000000000000
0000000000000000000000000000000000000000
0000000000000000000000000000000000000000
0000000000000000000000000000000000000000
0000000000000000000000000000000000000000
0000000000000000000000000000000000000000
0000000000000000000000000000000000000000
0000000000000000000000000000000000000000
0000000000000000000000000005000000000000
0000000000000000000000000000000000000000
0000000000000000000000000700070000000000
0000000000000000000000000000000000000000
0000000000000000000000000000000000000000
0000000000000000000000000000000000000000
0000000000000000000000000000000000000000
0000000000000000000000000000000000000000
0000000000000000000000000000000000000000
0000000000000000000000000000000000000000
0000000000000000000000000000000000000000
1414141414141414141414141414141414141414
1414141414141414141414141414141414141414
1414141414141414141414141414141414141414
1414141414141414141414141414141414141414
1414141400000018180000000000000000141414
1414141400300000000036000000363000141414
1414141400000000000000000000000000141414
1414141400000000000000000000000000141414
1414141400000000000000090909090900141414
1414141400000000000000090909090918141414
1414141400000000000000090909090918141414
1414141400003600000000090909090900141414
1414141400000000360000000000000000141414
1414141400000000000000000000000000141414
1414141400300000000000000000003000141414
1414141400000000000000000000000000141414
1414141414141414141414141414141414141414
1414141414141414141414141414141414141414
1414141414141414141414141414141414141414
1414141414141414141414141414141414141414