0000000000000000000000000000000000000000
0000000000000000000000000000000000000000
0000000000000000000000000000000000000000
0000000000000000000000000000000000000000
0000000000000000030000000000000000000000
0000000065656565656565656565650000000000
0000000065656565656565656565650000000000
0000000065656565656565656565650000000000
0000000065656565656565656565650000000000
0000000065656565656565656565650000000000
0000000065656565656565656565650600000000
0000000065656565656565656565650000000000
0000000065656565656565656565650000000000
0000000065656565656565656565650000000000
0000000065656565656565656565650000000000
0000000065656503656565656565650000000000
0000000000000000000000000000000000000000
0000000000000000000000000000000000000000
0000000000000000000000000000000000000000
0000000000000000000000000000000000000000
0000000000000000000000000000000000000000
0000000000000000000000000000000000000000
0000000000000000000000000000000000000000
0000000000000000000000000000000000000000
0000004273737373007373737373734100000000
0000004200000000000000000000004100000000
0000004200000000000000000000004100000000
0000004265656565000065656565654100000000
0000004200000000000000000000004100000000
0000004200000000000000000000004500000000
0000004200000000000000000000004800000000
0000004200000000000000000000004100000000
0000004265656565656565656565654100000000
0000004200000000000000000000004100000000
0000004200000000000000000000004100000000
0000001345454500454545454545454600000000
0000000000000000000000000000000000000000
0000000000000000000000000000000000000000
0000000000000000000000000000000000000000
0000000000000000000000000000000000000000
0000000000000000000000000000000000000000
0000000000000000000000000000000000000000
0000000000000000000000000000000000000000
0000000000000000000000000000000000000000
0000000000000000000000000000000000000000
0000000000000000000000000000000000000000
0000000000000000000000000000000000000000
0000000000000000000000000000000000000000
0000000000000000000000000000000000000000
0000000000000008000000000000000000000000
0000000000000000000000000000000000000000
0000000000080008000000000000000000000000
0000000000000000000000000000000000000000
0000000000000000000000000000000000000000
0000000000000000000000000000000000000000
0000000000000000000000000000000000000000
0000000000000000000000000000000000000000
0000000000000000000000000000000000000000
0000000000000000000000000000000000000000
0000000000000000000000000000000000000000
0000000000000000000000000000000000000000
0000000000000000000000000000000000000000
0000000000000000000000000000000000000000
0000000000000000000000000000000000000000
0000000000000000180000000000000000000000
0000000000380000000000000000000000000000
0000000000000000000000000000000000000000
0000000000000000191900000000000000000000
0000000000000000000000000000000000000000
0000000000070000000000000000001800000000
0000000000000000000000000000000000000000
0000000000000000002100000000000000000000
0000000000000000000000000000000000000000
0000000000000000000000000000000000000000
0000000000000000000000000038000000000000
0000000000000018000000000000000000000000
0000000000000000000000000000000000000000
0000000000000000000000000000000000000000
0000000000000000000000000000000000000000
0000000000000000000000000000000000000000