0000000000000000000000000000000000000000
0000000000000000000000000000000000000000
0000000000000000000000000000000000000000
0000000000000000000000000000000000000000
0000000000000003000000000000000000000000
0000000000656565656565656565656500000000
0000000000656565656565656565656500000000
0000000000656565656565656565656500000000
0000000000656565656565656565656500000000
0000000000000065000000000000000000000000
0000000000000065000000000000000000000000
0000000000000065000000000000000000000000
0000000065656565656565000000000000000000
0000000065656565656565000000000000000000
0000000065656565656565000000000000000000
0000000065656565656565000000000000000000
0000000000000000000000000000000000000000
0000000000000000000000000000000000000000
0000000000000000000000000000000000000000
0000000000000000000000000000000000000000
0000000000000000000000000000000000000000
0000000000000000000000000000000000000000
0000000000000000000000000000000000000000
0000000000000000000000000000000000000000
0000000042737300737373737373737341000000
0000000042000000000000000000000041000000
0000000042000000000000000000000041000000
0000000042000000000000000000000045000000
0000000042000000000000000000000048000000
0000000013454700484545454545454546000000
0000000000004200410000000000000000000000
0000000042737300737341000000000000000000
0000000042000000000041000000000000000000
0000000042000000000041000000000000000000
0000000042000000000041000000000000000000
0000000013454545454546000000000000000000
0000000000000000000000000000000000000000
0000000000000000000000000000000000000000
0000000000000000000000000000000000000000
0000000000000000000000000000000000000000
0000000000000000000000000000000000000000
0000000000000000000000000000000000000000
0000000000000000000000000000000000000000
0000000000000000000000000000000000000000
0000000000000000000000000000000000000000
0000000000000000000000000000000000000000
0000000000000000000000000000000000000000
0000000000000000000000000000000000000000
0000000000000000000000000000000000000000
0000000000000000000000000000000000000000
0000000000000000000000000000000000000000
0000000000000000000000000000000000000000
0000000000070000000000000000000000000000
0000000000000007000000000000000000000000
0000000000000000000700000000000000000000
0000000000000000000000000000000000000000
0000000000000000000000000000000000000000
0000000000000000000000000000000000000000
0000000000000000000000000000000000000000
0000000000000000000000000000000000000000
0000000000000000000000000000000000000000
0000000000000000000000000000000000000000
0000000000000000000000000000000000000000
0000000000000000000000000000000000000000
0000000000003018300000000000000000000000
0000000000210000000036000000360000000000
0000000000000000000000000000000000000000
0000000000000000000000000000000018000000
0000000000000000000000000000000000000000
0000000000000000000000000000000000000000
0000000000000000000000000000000000000000
0000000000000019000000000000000000000000
0000000000000000000000000000000000000000
0000000000000000000000000000000000000000
0000000000060600000000000000000000000000
0000000000000000000000000000000000000000
0000000000000000000000000000000000000000
0000000000000000000000000000000000000000
0000000000000000000000000000000000000000
0000000000000000000000000000000000000000