0000000000000000000000000000000000000000
0000000000000000000000000000000000000000
0000000000000000000000000000000000000000
0000000000000000000000000000000000000000
0000000000000000000000000000000000000000
0000000000666666666666666666666600000000
0000000000666666666666666666666600000000
0000000000666666666666666666666600000000
0000000000666666666666666666666600000000
0000000066666666666666666666666600000000
0000000066666666666666666666666600000000
0000000000666666666666666666666600000000
0000000000666666666666666666666600000000
0000000000666666666666666666666600000000
0000000000666666666666666666666600000000
0000000000000000666600000000000000000000
0000000000000000000000000000000000000000
0000000000000000000000000000000000000000
0000000000000000000000000000000000000000
0000000000000000000000000000000000000000
0000000000000000000000000000000000000000
0000000000000000000000000000000000000000
0000000000000000000000000000000000000000
0000000000000000000000000000000000000000
0000000073737373737373737373737373000000
0000000073000000000000000000000073000000
0000000073000000000000000000000073000000
0000000073000000000000000000000073000000
0000000073000000000000000000000073000000
0000000000000000000000000000000073000000
0000000000000000000000000000000073000000
0000000073000000000000000000000073000000
0000000073000000000000000000000073000000
0000000073000000000000000000000073000000
0000000073000000000000000000000073000000
0000000073737373000073737373737373000000
0000000000000000000000000000000000000000
0000000000000000000000000000000000000000
0000000000000000000000000000000000000000
0000000000000000000000000000000000000000
0000000000000000000000000000000000000000
0000000000000000000000000000000000000000
0000000000000000000000000000000000000000
0000000000000000000000000000000000000000
0000000000000000000000000000000000000000
0000000000000000000000000000000000000000
0000000000000000000000000000000000000000
0000000000000000000000000000000000000000
0000000000000000000000000000080000000000
0000000000000000000000000000000000000000
0000000000000000000000000000000000000000
0000000000000000000000000000000000000000
0000000000000000000000000000000000000000
0000000000000000000000000000000000000000
0000000000000000000000000000000000000000
0000000000000000000000000000000000000000
0000000000000000000000000000000000000000
0000000000000000000000000000000000000000
0000000000000000000000000000000000000000
0000000000000000000000000000000000000000
1414141414141414141414141414141414141414
1414141414141414141414141414141414141414
1414141414141414141414141414141414141414
1414141414141414141414141414141414141414
1414141400000000000000000000000000141414
1414141400300000000000000000003000141414
1414141400000000000000000000060000141414
1414141400003600000000003600000000141414
1414141400000000000000000000000000141414
1414141418000000000000000000000000141414
1414141418003600000036000036000000141414
1414141400000000000000000000000000141414
1414141400000036000000360000000000141414
1414141400000000000000000000000000141414
1414141400300000000000000000003000141414
1414141400000000181800000000000000141414
1414141414141414141414141414141414141414
1414141414141414141414141414141414141414
1414141414141414141414141414141414141414
1414141414141414141414141414141414141414