0000000000000000000000000000000000000000
0000000000000000000000000000000000000000
0000000000000000000000000000000000000000
0000000000000000000000000000000000000000
0000000000000000000000000000000000000000
0000000000000000000000000000000000000000
0000000000000700000000000000000000000000
0000000000111313131313131313080000000000
0000000000140707071212070707150000000000
0000000000140707096262100707150000000000
0000000007070715626161621407076666000000
0000000007070715626161621407150000000000
0000000000140707086262110707150000000000
0000000000140707071313070707150000000000
0000000000140707070707070707150000000000
0000000000101212120707121212090000000000
0000000000000000000707000000000000000000
0000000000000000000000000000000000000000
0000000000000000000000000000000000000000
0000000000000000000000000000000000000000
0000000000000000000000000000000000000000
0000000000000000000000000000000000000000
0000000000000000000000000000000000000000
0000000000000000000000000000000000000000
0000000000000000000000000000000000000000
0000000000004000000000000000000000000000
0000000042430043434444434343434100000000
0000000042000000000000000000004100000000
0000000042000000000000000000004100000000
0000004243000000520000530000004343410000
0000004200000000006667000000000000410000
0000004200000000006869000000004845460000
0000001347000000520000530000004100000000
0000000042000000000000000000004100000000
0000000042000000000000000000004100000000
0000000042000000000000000000004100000000
0000000013454545470000484545454600000000
0000000000000000134545460000000000000000
0000000000000000000000000000000000000000
0000000000000000000000000000000000000000
0000000000000000000000000000000000000000
0000000000000000000000000000000000000000
0000000000000000000000000000000000000000
0000000000000000000000000000000000000000
0000000000000000000000000000000000000000
0000000000000000000000000000000000000000
0000000000000000000000000000000000000000
0000000000000000000000000000000000000000
0000000000000000000000000000000000000000
0000000000000000000000000000000000000000
0000000000000000000000000000000000000000
0000000000000000000000000000000000000000
0000000000000000000000000000000000000000
0000000000000000000000000000000000000000
0000000000000000000000000000000000000000
0000000000000000000000000000000000000000
0000000000000000000000000000000000000000
0000000000000000000000000000000000000000
0000000000000000000000000000000000000000
0000000000000000000000000000000000000000
0000000000000000000000000000000000000000
0000000000000000000000000000000000000000
0000000000000000000000000000000000000000
0000000000000000000000000000000000000000
0000000000000000000000000000000000000000
0000000000000000000000000000000000000000
0000000000001200000000000000000000000000
0000000000000000000000000009090000000000
0000000000000000000000000009090000000000
0000000000000000000000000009090000000000
0000000018000000000000000009090018000000
0000000018000000000000000009090000000000
0000000000000000000000000009090000000000
0000000000000000000000000009090000000000
0000000000000000000000000009090000000000
0000000000000000004746000009090000000000
0000000000000000001818000000000000000000
0000000000000000000000000000000000000000
0000000000000000000000000000000000000000
0000000000000000000000000000000000000000