0000000000000000000000000000000000000000
0000000000000000000000000000000000000000
0000000000000000000000000000000000000000
0000000000000000000000000000000000000000
0000000000000000000000000000000000000000
0000000000000000000000000000000000000000
0000000000000000000000006600000000000000
0000000000000000000000116608000000000000
0000000011131313080000140715000000000000
0000000014070707090000140715000000000000
0000000014070707071313070715000000000000
0000000014070707070707070715000000000000
0000000014070707070707070715000000000000
0000000014070707070707070715000000000000
0000000014070707070707070715000000000000
0000000010120712121212121209000000000000
0000000000000700000000000000000000000000
0000000000000000000000000000000000000000
0000000000000000000000000000000000000000
0000000000000000000000000000000000000000
0000000000000000000000000000000000000000
0000000000000000000000000000000000000000
0000000000000000000000000000000000000000
0000000000000000000000000000000000000000
0000000000000000000000000000000000000000
0000000000000000000000004000000000000000
0000000000000000000042440044410000000000
0000004243434343434142000000410000000000
0000004200000000004142000000410000000000
0000004200000000004343000000410000000000
0000004200000000000000000000410000000000
0000004200000000000000000000410000000000
0000004200000000000000000000410000000000
0000004200000000000000000000410000000000
0000004200000000000000000000410000000000
0000004200000000000000000000410000000000
0000001345470048454545454545460000000000
0000000000134546000000000000000000000000
0000000000000000000000000000000000000000
0000000000000000000000000000000000000000
0000000000000000000000000000000000000000
0000000000000000000000000000000000000000
0000000000000000000000000000000000000000
0000000000000000000000000000000000000000
0000000000000000000000000000000000000000
0000000000000000000000000000000000000000
0000000000000000000000000000000000000000
0000000000000000000000000000000000000000
0000000000000000000000000000000000000000
0000000000000000000000000000000000000000
0000000000000000000000000000000000000000
0000000000000000000000000000000000000000
0000000000000000000000000000000000000000
0000000000000000000000000000000000000000
0000000000000000000000000000000000000000
0000000000000000000000000000000000000000
0000000000000000000000000000000000000000
0000000000000000000000000000000000000000
0000000000000000000000000000000000000000
0000000000000000000000000000000000000000
0000000000000000000000000000000000000000
0000000000000000000000000000000000000000
0000000000000000000000000000000000000000
0000000000000000000000000000000000000000
0000000000000000000000000000000000000000
0000000000000000000000000000000000000000
0000000000000000000000001100000000000000
0000000000003500000000470046000000000000
0000000002020002020000000000000000000000
0000000050504950500000000000000000000000
0000000001000000010000000000000000000000
0000000001000000010000000909000000000000
0000000001000000010000090909000000000000
0000000000000000000000090909000000000000
0000000000000000000000090909000000000000
0000000000000000000000090909000000000000
0000000000001800000000000000000000000000
0000000000000000000000000000000000000000
0000000000000000000000000000000000000000
0000000000000000000000000000000000000000