0000000000000000000000000000000000000000
0000000000000000000000000000000000000000
0000000000000000000000000000000000000000
0000000707000000000000000000070700000000
0000000007070000000000000707070700000000
0000000707000000000000000007070700000000
0000070707070000000000000007070707000000
0000070707070707070707070707070000000000
0000070007000000000000000707000000000000
0000070707071313131313000000000700000000
0000070707001212121212070707070707070000
0000000007000007000007070000070700000000
0000000007000000000000000000000000000000
0007070707000000000000000000000000000000
0000070007000000000000000000000000000000
0000000007000000000000000000000000000000
0000000707000000000000000000000000000000
0000000000000000000000000000000000000000
0000000000000000000000000000000000000000
0000000000000000000000000000000000000000
0000000000000000000000000000000000000000
0000000000000000000000000000000000000000
0000000040000000000000000000004000000000
0042434300434343434343434343430043430000
0042006300630000000000006363630063410000
0042636300630000000000006300000063410000
0042000000636363636363636300636363410000
0042006300000000000000000000630000410000
0042006363636300636363630063630000410000
0042000000000000000000630063636363434100
0042636300630000000000000000000000004100
0042006300636300636300636363636363484600
4243636300636363636363630000000000410000
4200000000630000000000000000000000410000
1347636300630000000000000000000000410000
0042006300630000000000000000000000410000
0042006300630000000000000000000000410000
0013454545454545454545454545454545460000
0000000000000000000000000000000000000000
0000000000000000000000000000000000000000
0000000000000000000000000000000000000000
0000000000000000000000000000000000000000
0000000000000000000000000000000000000000
0000000000000000000000000000000000000000
0000000000000000000000000000000000000000
0000000000000000000000000000000000000000
0000000000000000000000000000000000000000
0000000006000000000000000000000000000000
0000000000000000000000000600000000000000
0000000000000000000700000000000000000000
0000000000000000000000000000000000000000
0000000000000000000000000000000000000000
0000000000000000000000000000000000000000
0000000000000000000000000000000000000000
0000000000000000000000000000000000000000
0000000000000000000000000000000000000000
0000000000000000000000000000000000000000
0000000000000000000000000000000000000000
0000000000000000000000000000000000000000
0000000000000000000000000000000000000000
0000000000000000000000000000000000000000
0000000000000000000000000000000000000000
0000000000000000000000000000000000000000
0000000012000000000000000000001800000000
0000000000000000000000000000000000000000
0000000000000000000000000000000000000000
0000000000000000000000000000000000000000
0000190000000000000000000000000000000000
0000000000000020000000000000000000000000
0000000000190000000000001900000000000000
0000000000000000000000200000000000180000
0000000000000038000006000000000000000000
0000000000000000000000000000000000000000
0018000000000000000000000000000000000000
0000000020000000000000000000000000000000
0000000000000000000000000000000000000000
0000000018000000000000000000000000000000
0000000000000000000000000000000000000000
0000000000000000000000000000000000000000
0000000000000000000000000000000000000000