0000000000000000000000000000000000000000
0000000000000000000000000000000000000000
5555555555555555555555555555555555555555
5555555555555555555555555555555555555555
5459595355555555555555555555555555555555
5746465600000000004600000000005555555555
5746465600545959594659595953005555555555
5746465600574646464646464656005555555555
5746465600574646464646464656005555555555
5746465600574646464646464656005555555555
5160605200574646464646464656005459595359
5555555500574646464646464656555746465646
5555555500574646464646464656555746465646
5555555500574646464646464656005746465646
5555555500574646464646464656005746465646
5555555500574646464646464656005746465646
5555555500516060606060606052005746465646
5555555500000000000000000000005148605646
5554535555555555555500555555005551605260
5557565555555555555555555555555555555555
0000000000000000000000000000000000000000
0000000000000000000000000000000000000000
0000000000000000000000000000000000000000
0000000000000000000000000000000000000000
0000000000000000005500000000000000000000
0000000054545454550055545454540000000000
0000000054000000000000000000540000000000
0000000054000000000000000000540000000000
0000000054000000000000000000540000000000
0000000054000000000000000000545454545454
0000000054000000000000000000540000000054
0000000054000000000000000000000000000054
0000000054000000000000000000000000000054
0000000054000000000000000000540000000054
0000000054000000000000000000540000000054
0000000054000000000000000000540000000054
0000000054000000000000000000540000000054
0000000054545454545454545454540000000054
0000000000000000545454545400545400000054
0000000000000000000000000000005454545454
0000000000000000000000000000000000000000
0000000000000000000000000000000000000000
0000000000000000000000000000000000000000
0000000000000000000000000000000000000000
0000000000000000000000000000000000000000
0000000000000000000000000000000000000000
0000000000000000000000000000000000000000
0000000000000000000000000000000000000000
0000000000000000000000000000000000000000
0000000000000000000000000000000000000000
0000000000000000000000000000000000000000
0000000000000000000000000000000000000000
0000000000000000000000000000000000000000
0000000000000000000000000000000000000000
0000000000000000000000000000000000000000
0000000000000000000000000000000000000000
0000000000000000000000000000000000000000
0000000000000000000000000000000000000000
0000000000000000000000000000000000000000
0000000000000000000000000000000000000000
0000000000000000000000000000000000000000
0000000000000000000000000000000000000000
0000000000000000000000000000000000000000
0000000000000000000000000000000000000000
0000000000000000000000000000000000000000
0000000000000000001200000000000000000000
0009090000000000000000000000000000000000
0009090000000000000000100000000000000000
0009090000000000000000000000000000000000
0000000000000009090909090000000000000000
0000000000000009090909090000000000000000
0000000000000009090709090000000000060000
0000000000000009090909090000000000000000
0000000000000009090909090000000000090000
0000000000000000000000001000000000090000
0000000000000000000000000000000000090000
0000000000000000000000000000000000000000
0000000000000000000000000000000000060000
0000000000000000000000000000000000000000
0000000000000000000000000000000000000000