0000000000000000000000000000000000000000
0000000000000000000000000000000000000000
5555555555555555555555555555555555555555
5555555555555555555555555555555555555555
5555555555555555555555005555555555555555
5555555555550000000000460000000055555555
0000000000000000545959465959530055555555
0000000000000000584646464646560055555555
0000545959530000584646464646560055555555
0000574646560000584646464646560055555555
0000574646560000584646464646560055555555
0000574646560000584646464646560055555555
0000516060520000584646464646560055555555
0000000000000000584646464646560055555555
0000000000000000584646464646560055555555
0000000000000000516048476060520055555555
0000000000000000000051520000000055555555
5555555555555555555500555555555555555555
5555555555555555555555555555555555555555
5555555555555555555555555555555555555555
0000000000000000000000000000000000000000
0000000000000000000000000000000000000000
0000000000000000000000000000000000000000
0000000000000000000000000000000000000000
0000000000000000000000540000000000000000
0000000000005454545454005454545400000000
5454545454545454000000000000005400000000
5454545454545454000000000000005400000000
5454000000005454000000000000005400000000
5454000000005454000000000000005400000000
5454000000005454000000000000005400000000
5454000000005454000000000000005400000000
5454000000005454000000000000005400000000
5454545454545454000000000000005400000000
5454545454545454000000000000005400000000
5454545454545454000000000000005400000000
5454545454545454545400005454545400000000
0000000000000000000054540000000000000000
0000000000000000000000000000000000000000
0000000000000000000000000000000000000000
0000000000000000000000000000000000000000
0000000000000000000000000000000000000000
0000000000000000000000000000000000000000
0000000000000000000000000000000000000000
0000000000000000000000000000000000000000
0000000000000000000000000000000000000000
0000000000000000000000000000000000000000
0000000000000000000000000000000000000000
0000000000000000000000000000000000000000
0000000200000000000000000000000000000000
0000000200000000000000000000000000000000
0000000002000000000000000000000000000000
0000000000000000000000000000000000000000
0000000000000000000000000000000000000000
0000000000000000000000000000000000000000
0000000000000000000000000000000000000000
0000000000000000000000000000000000000000
0000000000000000000000000000000000000000
0000000000000000000000000000000000000000
0000000000000000000000000000000000000000
0000000000000000000000000000000000000000
0000000000000000000000000000000000000000
0000000000000000000000000000000000000000
0000000000000000000000000000000000000000
0000000000000000000000000000000000000000
0000000000000000000000120000000000000000
0000000000000000000000000000000000000000
0000000000000000000000000000000000000000
0000000000000000000000000000000000000000
0000000000000000000000000000000000000000
0000000000000000000000000000000000000000
0000000000000000000000000000000000000000
0000000000000000000000000010000000000000
0000000000000000000000000000000000000000
0000000000000000000000000000000000000000
0000000000000000000000000000000000000000
0000000000000000000018180000000000000000
0000000000000000000000000000000000000000
0000000000000000000000000000000000000000
0000000000000000000000000000000000000000