0000000000000000000000000000000000000000
0000000000000000000000000000000000000000
5555555555555555000000555555555555555555
5555555555555555464646545953000000555555
5555555555555555004655574656000000555555
5555555555555555004600516052000055555555
5555555555550000004600000000000055555555
5555555555005459594659595959530055555555
5555555555005746464646464646560055555555
5555555555005746464646464646560000555555
5555555555005746464646464646560000555555
5555555555005746464646464646560000555555
5555555555005746464646464646560000555555
5555555555005746464646464646560000555555
5555555555005746464646464646560000555555
5555555555005160606060606060520000555555
5555555555000000000000000000000000555555
5555555555555555555555555555555555555555
5555555555555555555555555555555555555555
5555555555555555555555555555555555555555
0000000000000000000000000000000000000000
0000000000000000000000000000000000000000
0000000000000054545454000000000000000000
0000000000000000000054000000545454000000
0000000000000000540054000000545454000000
0000000000000000540054000000545400000000
0000000000005454540054545454545400000000
0000000000540000000000000000005400000000
0000000000540000000000000000005400000000
0000000000540000000000000000005454000000
0000000000540000000000000000005454000000
0000000000540000000000000000005454000000
0000000000540000000000000000005454000000
0000000000540000000000000000005454000000
0000000000540000000000000000005454000000
0000000000540000000000000000005454000000
0000000000545454545454545454545454000000
0000000000000000000000000000000000000000
0000000000000000000000000000000000000000
0000000000000000000000000000000000000000
0000000000000000000000000000000000000000
0000000000000000000000000000000000000000
0000000000000000000000000000000000000000
0000000000000000000000000000000000000000
0000000000000000000000000000000000000000
0000000000000000000000000000000000000000
0000000000000000000000000000000000000000
0000000000000000000000000000000000000000
0000000000000000000000000000000000000000
0000000000000000000000000000000000000000
0000000000000000000000000000000000000000
0000000000000000000000000000000000000000
0000000000000000010000000000000000000000
0000000000000002000000000000000000000000
0000000000000000000000000000000000000000
0000000000000000000000000000000000000000
0000000000000000000000000000000000000000
0000000000000000000000000000000000000000
0000000000000000000000000000000000000000
0000000000000000000000000000000000000000
0000000000000000000000000000000000000000
0000000000000000000000000000000000000000
0000000000000000000000000000000000000000
0000000000000000191819000000000000000000
0000000000000000002000002100000000000000
0000000000000000002000000000000000000000
0000000000000000002000000000000000000000
0000000000000000002000000000000000000000
0000000000000009090909090909000000000000
0000000000000009090909090909000000000000
0000000000001919191919191919190000000000
0000000000000000000000000000000000000000
0000000000000000000000100000000000000000
0000000000000000000000000000000000000000
0000000000000000000000002100000000000000
0000000000000000000000000000000000000000
0000000000000000000000000000000000000000
0000000000000000000000000000000000000000
0000000000000000000000000000000000000000
0000000000000000000000000000000000000000