00000000000000000000
00000000000000000000
00000000000000000000
00000000000000000000
00000000000000000000
00000000000000000000
00000000000000000000
00000000000000000000
00000000000000000000
00000000000000000000
00000000000000000000
00000000000000000000
00000000000000000000
00000000000000000000
00000000000000000000
00000000000000000000
00000000000000000000
00000000000000000000
00000000000000000000
00000000000000000000
56565656565656565656
65656565656565656165
56565656565656565656
65656565656565656561
56565656565656565656
65656565656565656565
IGGGGGGGGGGGGGGJ5252
M00000YaaaaaX00F2525
M00000WUUUUUV00F5252
M00000ROPOPOQ00F2525
M00000RPO0OPQ00F1252
M00000000000000F2525
M00000000000000F5252
M00000000000000F2525
M00000000000000F5252
M00000000000000F6525
M00000000000000F5252
EHHHHHHHHc00000F2525
BBBBBBBBBM00012F5656
BBBBBBBBBM00034F6565
00000000000000000000
00000000000000000000
00000000000000000000
00000000000000000000
00000000000000000000
00000000000000000000
00000000000000000000
00000000000000000000
00000000000000000000
00000000000000000000
00000000000000000000
00000000000000000000
00000000000000000000
00000000000000000000
00000000000000000000
00000000000000000000
00000000000000000000
00000000000000000000
00000000000000000000
00000000000000000000
00000000000000000000
00000000000000000000
00000000000000000000
00000000000000000000
00000000000000000000
00000000000000000000
00000000000000000000
00000000000000000000
00000000000000000000
00000000000000000000
00000000030000000000
00000000000000000000
00000000000000000000
00000000000000000000
00000000000000000000
00000000000000000000
00000000000000000000
00000000000000000000
00000000000000000000
00000000000000000000